electoral_district,reported,Harris-Walz_Democratic,Trump-Vance_Republican,Trump-Vance_Conservative,Harris-Walz_Working_Families,write_in,assembly_district,ed_map_for_viz,total_votes,trump_votes,harris_votes,vote_counts,trump_votes_pct,harris_votes_pct,vote_counts_pct
ED 1,99.00%,371,168,7,26,3,AD   77,77001,575,175,397,-222,30.434782608695656,69.04347826086956,-38.60869565217391
ED 2,99.00%,503,200,7,17,6,AD   77,77002,733,207,520,-313,28.240109140518417,70.94133697135061,-42.701227830832195
ED 3,99.00%,471,144,18,12,2,AD   77,77003,647,162,483,-321,25.0386398763524,74.65224111282845,-49.61360123647605
ED 4,83.33%,94,27,2,6,2,AD   77,77004,131,29,100,-71,22.137404580152673,76.33587786259542,-54.19847328244275
ED 5,99.00%,470,178,11,11,2,AD   77,77005,672,189,481,-292,28.125,71.57738095238095,-43.45238095238095
ED 6,99.00%,466,155,15,18,2,AD   77,77006,656,170,484,-314,25.914634146341463,73.78048780487805,-47.86585365853659
ED 7,99.00%,478,202,11,12,4,AD   77,77007,707,213,490,-277,30.12729844413013,69.3069306930693,-39.17963224893917
ED 8,99.00%,414,145,10,11,7,AD   77,77008,587,155,425,-270,26.405451448040886,72.40204429301534,-45.99659284497445
ED 9,99.00%,488,200,16,14,6,AD   77,77009,724,216,502,-286,29.83425414364641,69.33701657458563,-39.50276243093922
ED 10,99.00%,449,195,7,21,5,AD   77,77010,677,202,470,-268,29.83751846381093,69.42392909896603,-39.5864106351551
ED 11,99.00%,475,196,15,10,1,AD   77,77011,697,211,485,-274,30.272596843615496,69.58393113342898,-39.31133428981348
ED 12,99.00%,481,144,12,18,6,AD   77,77012,661,156,499,-343,23.600605143721634,75.49167927382754,-51.891074130105906
ED 13,99.00%,553,174,19,14,2,AD   77,77013,762,193,567,-374,25.32808398950131,74.40944881889764,-49.081364829396335
ED 14,99.00%,470,132,6,16,3,AD   77,77014,627,138,486,-348,22.00956937799043,77.51196172248804,-55.50239234449761
ED 15,99.00%,40,20,1,3,0,AD   77,77015,64,21,43,-22,32.8125,67.1875,-34.375
ED 16,99.00%,98,17,1,5,1,AD   77,77016,122,18,103,-85,14.754098360655737,84.42622950819673,-69.672131147541
ED 17,99.00%,348,92,6,8,1,AD   77,77017,455,98,356,-258,21.53846153846154,78.24175824175825,-56.70329670329671
ED 18,99.00%,350,103,5,16,5,AD   77,77018,479,108,366,-258,22.546972860125262,76.40918580375782,-53.86221294363256
ED 19,99.00%,418,94,5,10,1,AD   77,77019,528,99,428,-329,18.75,81.06060606060606,-62.31060606060606
ED 20,99.00%,141,51,3,5,1,AD   77,77020,201,54,146,-92,26.865671641791046,72.636815920398,-45.77114427860696
ED 21,99.00%,297,119,6,11,3,AD   77,77021,436,125,308,-183,28.6697247706422,70.64220183486239,-41.972477064220186
ED 22,85.71%,250,95,7,4,3,AD   77,77022,359,102,254,-152,28.412256267409468,70.75208913649024,-42.33983286908077
ED 23,85.71%,365,132,6,17,2,AD   77,77023,522,138,382,-244,26.436781609195403,73.18007662835248,-46.743295019157074
ED 24,99.00%,401,114,12,11,2,AD   77,77024,540,126,412,-286,23.333333333333332,76.29629629629629,-52.96296296296296
ED 25,99.00%,246,95,2,6,2,AD   77,77025,351,97,252,-155,27.635327635327634,71.7948717948718,-44.15954415954416
ED 26,99.00%,350,166,6,9,1,AD   77,77026,532,172,359,-187,32.33082706766917,67.4812030075188,-35.15037593984963
ED 27,99.00%,379,163,6,10,2,AD   77,77027,560,169,389,-220,30.178571428571427,69.46428571428571,-39.28571428571428
ED 28,99.00%,264,93,5,5,4,AD   77,77028,371,98,269,-171,26.41509433962264,72.50673854447439,-46.09164420485175
ED 29,99.00%,114,42,5,3,1,AD   77,77029,165,47,117,-70,28.484848484848484,70.9090909090909,-42.42424242424242
ED 30,99.00%,156,51,3,3,0,AD   77,77030,213,54,159,-105,25.352112676056336,74.64788732394366,-49.29577464788733
ED 31,99.00%,334,123,6,10,3,AD   77,77031,476,129,344,-215,27.100840336134453,72.26890756302521,-45.168067226890756
ED 32,99.00%,370,131,7,9,5,AD   77,77032,522,138,379,-241,26.436781609195403,72.60536398467433,-46.16858237547892
ED 33,87.50%,171,59,8,6,3,AD   77,77033,247,67,177,-110,27.125506072874494,71.65991902834008,-44.53441295546559
ED 34,87.50%,149,81,6,3,1,AD   77,77034,240,87,152,-65,36.25,63.33333333333333,-27.08333333333333
ED 35,87.50%,283,122,8,5,5,AD   77,77035,423,130,288,-158,30.73286052009456,68.08510638297872,-37.35224586288416
ED 36,87.50%,253,117,3,6,2,AD   77,77036,381,120,259,-139,31.496062992125985,67.97900262467192,-36.482939632545936
ED 37,87.50%,338,108,11,17,3,AD   77,77037,477,119,355,-236,24.947589098532493,74.42348008385744,-49.47589098532495
ED 38,99.00%,246,74,5,6,3,AD   77,77038,334,79,252,-173,23.652694610778443,75.44910179640718,-51.79640718562874
ED 39,87.50%,340,167,6,8,2,AD   77,77039,523,173,348,-175,33.07839388145315,66.53919694072657,-33.46080305927342
ED 40,99.00%,348,125,15,10,4,AD   77,77040,502,140,358,-218,27.88844621513944,71.31474103585657,-43.42629482071713
ED 41,99.00%,387,161,7,19,5,AD   77,77041,579,168,406,-238,29.015544041450774,70.12089810017271,-41.105354058721936
ED 42,99.00%,398,156,9,4,2,AD   77,77042,569,165,402,-237,28.998242530755714,70.65026362038664,-41.65202108963092
ED 43,99.00%,0,1,0,0,0,AD   77,77043,1,1,0,1,100.0,0.0,100.0
ED 44,99.00%,422,136,4,10,7,AD   77,77044,579,140,432,-292,24.179620034542314,74.61139896373057,-50.431778929188255
ED 45,83.33%,51,14,1,0,0,AD   77,77045,66,15,51,-36,22.727272727272727,77.27272727272727,-54.54545454545454
ED 46,83.33%,325,112,1,11,4,AD   77,77046,453,113,336,-223,24.944812362030905,74.17218543046357,-49.22737306843267
ED 47,99.00%,510,129,10,29,14,AD   77,77047,692,139,539,-400,20.08670520231214,77.89017341040463,-57.80346820809249
ED 48,83.33%,152,54,2,2,4,AD   77,77048,214,56,154,-98,26.168224299065418,71.96261682242991,-45.79439252336449
ED 49,99.00%,691,123,14,35,20,AD   77,77049,883,137,726,-589,15.51528878822197,82.21970554926388,-66.70441676104191
ED 50,83.33%,376,93,6,6,2,AD   77,77050,483,99,382,-283,20.496894409937887,79.08902691511386,-58.592132505175975
ED 51,99.00%,292,94,2,17,7,AD   77,77051,412,96,309,-213,23.300970873786408,75.0,-51.69902912621359
ED 52,99.00%,474,159,7,17,7,AD   77,77052,664,166,491,-325,25.0,73.94578313253012,-48.945783132530124
ED 53,99.00%,397,144,9,8,7,AD   77,77053,565,153,405,-252,27.079646017699115,71.68141592920354,-44.60176991150442
ED 54,99.00%,220,121,2,5,2,AD   77,77054,350,123,225,-102,35.14285714285714,64.28571428571429,-29.142857142857153
ED 55,99.00%,119,60,4,4,0,AD   77,77055,187,64,123,-59,34.22459893048128,65.77540106951871,-31.55080213903743
ED 56,99.00%,273,148,11,4,4,AD   77,77056,440,159,277,-118,36.13636363636364,62.95454545454545,-26.818181818181813
ED 57,99.00%,0,0,0,0,0,AD   77,77057,0,0,0,0,,,0.0
ED 58,83.33%,0,0,0,0,0,AD   77,77058,0,0,0,0,,,0.0
ED 59,99.00%,0,0,0,0,0,AD   77,77059,0,0,0,0,,,0.0
ED 60,99.00%,0,0,0,0,0,AD   77,77060,0,0,0,0,,,0.0
ED 61,99.00%,0,0,0,0,0,AD   77,77061,0,0,0,0,,,0.0
ED 62,99.00%,0,0,0,0,0,AD   77,77062,0,0,0,0,,,0.0
ED 63,99.00%,0,0,0,0,0,AD   77,77063,0,0,0,0,,,0.0
ED 1,99.00%,366,117,8,15,4,AD   78,78001,510,125,381,-256,24.509803921568626,74.70588235294117,-50.19607843137255
ED 2,99.00%,484,123,8,19,4,AD   78,78002,638,131,503,-372,20.532915360501566,78.84012539184953,-58.307210031347964
ED 3,99.00%,407,142,11,9,0,AD   78,78003,569,153,416,-263,26.889279437609844,73.11072056239016,-46.22144112478031
ED 4,99.00%,360,96,8,12,1,AD   78,78004,477,104,372,-268,21.80293501048218,77.9874213836478,-56.18448637316562
ED 5,99.00%,265,122,9,10,4,AD   78,78005,410,131,275,-144,31.951219512195124,67.07317073170732,-35.1219512195122
ED 6,99.00%,262,115,6,9,3,AD   78,78006,395,121,271,-150,30.632911392405067,68.60759493670886,-37.9746835443038
ED 7,99.00%,381,161,14,14,3,AD   78,78007,573,175,395,-220,30.54101221640489,68.93542757417103,-38.394415357766135
ED 8,99.00%,230,125,8,7,8,AD   78,78008,378,133,237,-104,35.18518518518518,62.698412698412696,-27.513227513227513
ED 9,99.00%,229,96,10,12,9,AD   78,78009,356,106,241,-135,29.775280898876407,67.69662921348315,-37.921348314606746
ED 10,99.00%,401,113,12,18,4,AD   78,78010,548,125,419,-294,22.81021897810219,76.45985401459853,-53.64963503649635
ED 11,99.00%,211,58,6,12,6,AD   78,78011,293,64,223,-159,21.843003412969285,76.10921501706484,-54.26621160409556
ED 12,87.50%,243,119,12,14,6,AD   78,78012,394,131,257,-126,33.24873096446701,65.22842639593908,-31.979695431472074
ED 13,87.50%,248,77,4,7,1,AD   78,78013,337,81,255,-174,24.03560830860534,75.66765578635015,-51.63204747774481
ED 14,99.00%,335,144,13,11,3,AD   78,78014,506,157,346,-189,31.027667984189723,68.37944664031622,-37.3517786561265
ED 15,99.00%,64,33,4,3,0,AD   78,78015,104,37,67,-30,35.57692307692308,64.42307692307693,-28.846153846153854
ED 16,99.00%,225,99,6,10,7,AD   78,78016,347,105,235,-130,30.25936599423631,67.72334293948127,-37.463976945244966
ED 17,99.00%,397,215,8,8,9,AD   78,78017,637,223,405,-182,35.00784929356358,63.57927786499214,-28.571428571428562
ED 18,99.00%,373,203,12,8,3,AD   78,78018,599,215,381,-166,35.89315525876461,63.60601001669449,-27.712854757929883
ED 19,99.00%,355,142,9,21,4,AD   78,78019,531,151,376,-225,28.436911487758948,70.80979284369114,-42.37288135593219
ED 20,99.00%,428,159,14,14,5,AD   78,78020,620,173,442,-269,27.903225806451616,71.29032258064515,-43.38709677419354
ED 21,99.00%,309,171,5,17,3,AD   78,78021,505,176,326,-150,34.85148514851485,64.55445544554456,-29.702970297029715
ED 22,99.00%,350,203,16,21,6,AD   78,78022,596,219,371,-152,36.74496644295302,62.248322147651,-25.50335570469798
ED 23,87.50%,363,147,9,20,8,AD   78,78023,547,156,383,-227,28.519195612431442,70.018281535649,-41.49908592321755
ED 24,87.50%,56,18,0,2,1,AD   78,78024,77,18,58,-40,23.376623376623375,75.32467532467533,-51.948051948051955
ED 25,99.00%,381,152,16,19,11,AD   78,78025,579,168,400,-232,29.015544041450774,69.08462867012089,-40.06908462867012
ED 26,87.50%,284,117,5,18,5,AD   78,78026,429,122,302,-180,28.438228438228435,70.3962703962704,-41.95804195804196
ED 27,87.50%,379,170,16,21,10,AD   78,78027,596,186,400,-214,31.20805369127517,67.11409395973155,-35.90604026845638
ED 28,99.00%,502,241,17,38,14,AD   78,78028,812,258,540,-282,31.773399014778324,66.50246305418719,-34.72906403940887
ED 29,99.00%,468,244,10,33,5,AD   78,78029,760,254,501,-247,33.421052631578945,65.92105263157895,-32.5
ED 30,99.00%,452,162,11,21,13,AD   78,78030,659,173,473,-300,26.251896813353564,71.77541729893778,-45.523520485584214
ED 31,99.00%,248,88,6,14,3,AD   78,78031,359,94,262,-168,26.18384401114206,72.98050139275766,-46.7966573816156
ED 32,99.00%,512,96,4,18,7,AD   78,78032,637,100,530,-430,15.698587127158556,83.20251177394034,-67.50392464678178
ED 33,90.00%,354,191,12,12,6,AD   78,78033,575,203,366,-163,35.30434782608695,63.65217391304348,-28.347826086956523
ED 34,90.00%,313,195,5,15,5,AD   78,78034,533,200,328,-128,37.5234521575985,61.53846153846154,-24.01500938086304
ED 35,90.00%,257,185,9,16,3,AD   78,78035,470,194,273,-79,41.27659574468085,58.08510638297872,-16.808510638297875
ED 36,99.00%,512,182,15,14,12,AD   78,78036,735,197,526,-329,26.802721088435373,71.56462585034014,-44.76190476190476
ED 37,99.00%,422,212,11,13,4,AD   78,78037,662,223,435,-212,33.68580060422961,65.70996978851964,-32.02416918429003
ED 38,90.00%,236,114,8,13,0,AD   78,78038,371,122,249,-127,32.88409703504043,67.11590296495957,-34.23180592991914
ED 39,99.00%,366,196,16,21,0,AD   78,78039,599,212,387,-175,35.39232053422371,64.60767946577629,-29.21535893155258
ED 40,99.00%,306,132,7,9,2,AD   78,78040,456,139,315,-176,30.482456140350877,69.07894736842105,-38.59649122807018
ED 41,99.00%,306,206,18,11,11,AD   78,78041,552,224,317,-93,40.57971014492754,57.427536231884055,-16.847826086956516
ED 42,99.00%,376,163,3,13,5,AD   78,78042,560,166,389,-223,29.642857142857142,69.46428571428571,-39.82142857142857
ED 43,99.00%,340,232,22,7,4,AD   78,78043,605,254,347,-93,41.98347107438016,57.35537190082645,-15.371900826446286
ED 44,99.00%,268,161,14,13,8,AD   78,78044,464,175,281,-106,37.71551724137931,60.560344827586206,-22.844827586206897
ED 45,99.00%,248,120,2,2,3,AD   78,78045,375,122,250,-128,32.53333333333333,66.66666666666666,-34.133333333333326
ED 46,99.00%,317,153,7,11,6,AD   78,78046,494,160,328,-168,32.388663967611336,66.39676113360325,-34.00809716599191
ED 47,99.00%,342,203,9,14,3,AD   78,78047,571,212,356,-144,37.127845884413304,62.34676007005254,-25.218914185639235
ED 48,99.00%,1,1,0,0,0,AD   78,78048,2,1,1,0,50.0,50.0,0.0
ED 49,99.00%,393,147,13,19,12,AD   78,78049,584,160,412,-252,27.397260273972602,70.54794520547945,-43.150684931506845
ED 50,99.00%,141,105,6,8,4,AD   78,78050,264,111,149,-38,42.04545454545455,56.439393939393945,-14.393939393939398
ED 52,99.00%,0,0,0,0,0,AD   78,78052,0,0,0,0,,,0.0
ED 53,99.00%,0,0,0,0,0,AD   78,78053,0,0,0,0,,,0.0
ED 54,87.50%,0,0,0,0,0,AD   78,78054,0,0,0,0,,,0.0
ED 55,99.00%,0,0,0,0,0,AD   78,78055,0,0,0,0,,,0.0
ED 1,99.00%,464,103,8,8,3,AD   79,79001,586,111,472,-361,18.941979522184297,80.54607508532423,-61.604095563139936
ED 2,99.00%,62,30,4,0,2,AD   79,79002,98,34,62,-28,34.69387755102041,63.26530612244898,-28.571428571428577
ED 3,99.00%,391,106,6,16,1,AD   79,79003,520,112,407,-295,21.53846153846154,78.26923076923077,-56.73076923076923
ED 4,99.00%,267,124,7,7,3,AD   79,79004,408,131,274,-143,32.1078431372549,67.15686274509804,-35.049019607843135
ED 5,99.00%,251,82,5,5,2,AD   79,79005,345,87,256,-169,25.217391304347824,74.20289855072464,-48.98550724637681
ED 6,99.00%,221,84,4,5,2,AD   79,79006,316,88,226,-138,27.848101265822784,71.51898734177216,-43.670886075949376
ED 7,99.00%,51,13,1,2,0,AD   79,79007,67,14,53,-39,20.8955223880597,79.1044776119403,-58.208955223880594
ED 8,99.00%,250,61,3,10,0,AD   79,79008,324,64,260,-196,19.753086419753085,80.24691358024691,-60.49382716049382
ED 9,99.00%,133,44,3,2,1,AD   79,79009,183,47,135,-88,25.683060109289617,73.77049180327869,-48.087431693989075
ED 10,99.00%,345,101,7,2,4,AD   79,79010,459,108,347,-239,23.52941176470588,75.59912854030502,-52.06971677559913
ED 11,99.00%,436,100,10,6,5,AD   79,79011,557,110,442,-332,19.748653500897667,79.35368043087972,-59.60502692998205
ED 12,99.00%,476,138,19,16,2,AD   79,79012,651,157,492,-335,24.11674347158218,75.57603686635944,-51.45929339477726
ED 13,99.00%,365,74,12,12,3,AD   79,79013,466,86,377,-291,18.4549356223176,80.90128755364807,-62.446351931330476
ED 14,99.00%,370,110,9,8,4,AD   79,79014,501,119,378,-259,23.75249500998004,75.44910179640718,-51.69660678642714
ED 15,99.00%,504,133,10,13,5,AD   79,79015,665,143,517,-374,21.503759398496243,77.74436090225564,-56.24060150375939
ED 16,99.00%,245,62,4,7,3,AD   79,79016,321,66,252,-186,20.5607476635514,78.50467289719626,-57.94392523364486
ED 17,99.00%,333,123,6,12,1,AD   79,79017,475,129,345,-216,27.157894736842103,72.63157894736842,-45.47368421052632
ED 18,99.00%,285,70,6,11,3,AD   79,79018,375,76,296,-220,20.266666666666666,78.93333333333334,-58.66666666666667
ED 19,99.00%,190,50,2,4,0,AD   79,79019,246,52,194,-142,21.138211382113823,78.86178861788618,-57.72357723577235
ED 20,99.00%,386,101,8,12,4,AD   79,79020,511,109,398,-289,21.330724070450096,77.88649706457925,-56.55577299412915
ED 21,99.00%,283,84,7,13,7,AD   79,79021,394,91,296,-205,23.096446700507613,75.1269035532995,-52.030456852791886
ED 22,99.00%,380,119,10,11,4,AD   79,79022,524,129,391,-262,24.61832061068702,74.61832061068702,-50.0
ED 23,99.00%,397,196,7,13,4,AD   79,79023,617,203,410,-207,32.90113452188007,66.45056726094003,-33.54943273905997
ED 24,99.00%,314,103,5,13,1,AD   79,79024,436,108,327,-219,24.770642201834864,75.0,-50.22935779816514
ED 25,99.00%,206,76,2,6,0,AD   79,79025,290,78,212,-134,26.89655172413793,73.10344827586206,-46.206896551724135
ED 26,99.00%,224,65,5,14,3,AD   79,79026,311,70,238,-168,22.508038585209004,76.52733118971061,-54.0192926045016
ED 27,99.00%,424,117,11,15,5,AD   79,79027,572,128,439,-311,22.377622377622377,76.74825174825175,-54.37062937062937
ED 28,99.00%,506,132,11,23,8,AD   79,79028,680,143,529,-386,21.029411764705884,77.79411764705883,-56.76470588235294
ED 29,99.00%,484,154,7,22,4,AD   79,79029,671,161,506,-345,23.994038748137108,75.40983606557377,-51.41579731743666
ED 30,99.00%,328,78,6,12,2,AD   79,79030,426,84,340,-256,19.718309859154928,79.81220657276995,-60.093896713615024
ED 31,99.00%,312,98,11,13,3,AD   79,79031,437,109,325,-216,24.94279176201373,74.37070938215103,-49.42791762013731
ED 32,99.00%,492,158,15,15,6,AD   79,79032,686,173,507,-334,25.218658892128282,73.9067055393586,-48.688046647230316
ED 33,99.00%,233,56,8,12,3,AD   79,79033,312,64,245,-181,20.51282051282051,78.52564102564102,-58.01282051282051
ED 34,99.00%,406,158,9,15,4,AD   79,79034,592,167,421,-254,28.209459459459456,71.11486486486487,-42.90540540540542
ED 35,99.00%,445,109,17,18,2,AD   79,79035,591,126,463,-337,21.31979695431472,78.34179357021996,-57.02199661590524
ED 36,99.00%,339,103,11,9,6,AD   79,79036,468,114,348,-234,24.358974358974358,74.35897435897436,-50.00000000000001
ED 37,99.00%,449,149,13,13,6,AD   79,79037,630,162,462,-300,25.71428571428571,73.33333333333333,-47.61904761904762
ED 38,99.00%,330,101,8,6,7,AD   79,79038,452,109,336,-227,24.11504424778761,74.33628318584071,-50.221238938053105
ED 39,99.00%,277,82,6,7,2,AD   79,79039,374,88,284,-196,23.52941176470588,75.93582887700535,-52.406417112299465
ED 40,99.00%,513,138,12,6,1,AD   79,79040,670,150,519,-369,22.388059701492537,77.46268656716417,-55.07462686567163
ED 41,99.00%,313,89,9,10,6,AD   79,79041,427,98,323,-225,22.950819672131146,75.64402810304449,-52.693208430913344
ED 42,99.00%,321,101,10,12,3,AD   79,79042,447,111,333,-222,24.832214765100673,74.49664429530202,-49.664429530201346
ED 43,99.00%,707,155,19,32,7,AD   79,79043,920,174,739,-565,18.913043478260867,80.32608695652173,-61.41304347826087
ED 44,90.00%,331,115,12,18,2,AD   79,79044,478,127,349,-222,26.569037656903767,73.01255230125523,-46.44351464435146
ED 45,99.00%,329,93,5,14,3,AD   79,79045,444,98,343,-245,22.07207207207207,77.25225225225225,-55.18018018018017
ED 46,99.00%,493,149,9,27,3,AD   79,79046,681,158,520,-362,23.201174743024964,76.3582966226138,-53.15712187958884
ED 47,99.00%,505,132,11,32,9,AD   79,79047,689,143,537,-394,20.754716981132077,77.93904208998549,-57.184325108853415
ED 48,90.00%,76,21,0,6,1,AD   79,79048,104,21,82,-61,20.192307692307693,78.84615384615384,-58.653846153846146
ED 49,90.00%,147,53,2,5,1,AD   79,79049,208,55,152,-97,26.442307692307693,73.07692307692307,-46.63461538461537
ED 50,90.00%,334,109,7,21,1,AD   79,79050,472,116,355,-239,24.576271186440678,75.21186440677965,-50.635593220338976
ED 51,90.00%,319,148,13,14,6,AD   79,79051,500,161,333,-172,32.2,66.60000000000001,-34.400000000000006
ED 52,90.00%,354,105,6,11,2,AD   79,79052,478,111,365,-254,23.221757322175733,76.35983263598327,-53.13807531380753
ED 53,99.00%,303,77,5,12,0,AD   79,79053,397,82,315,-233,20.65491183879093,79.34508816120906,-58.69017632241813
ED 54,99.00%,565,63,13,15,6,AD   79,79054,662,76,580,-504,11.48036253776435,87.61329305135952,-76.13293051359517
ED 55,99.00%,690,92,17,26,6,AD   79,79055,831,109,716,-607,13.116726835138387,86.16125150421179,-73.04452466907341
ED 56,99.00%,396,60,8,12,2,AD   79,79056,478,68,408,-340,14.225941422594143,85.35564853556485,-71.1297071129707
ED 57,99.00%,174,63,5,8,3,AD   79,79057,253,68,182,-114,26.877470355731226,71.93675889328063,-45.0592885375494
ED 58,99.00%,65,23,4,4,0,AD   79,79058,96,27,69,-42,28.125,71.875,-43.75
ED 59,90.00%,207,59,4,2,1,AD   79,79059,273,63,209,-146,23.076923076923077,76.55677655677655,-53.479853479853475
ED 1,99.00%,85,30,3,5,2,AD   80,80001,125,33,90,-57,26.400000000000002,72.0,-45.599999999999994
ED 2,99.00%,296,125,6,12,9,AD   80,80002,448,131,308,-177,29.24107142857143,68.75,-39.50892857142857
ED 3,99.00%,289,163,16,15,12,AD   80,80003,495,179,304,-125,36.16161616161616,61.41414141414141,-25.252525252525253
ED 4,99.00%,175,220,21,8,6,AD   80,80004,430,241,183,58,56.04651162790698,42.55813953488372,13.488372093023258
ED 5,99.00%,249,175,11,19,38,AD   80,80005,492,186,268,-82,37.80487804878049,54.47154471544715,-16.666666666666664
ED 6,99.00%,375,303,27,29,23,AD   80,80006,757,330,404,-74,43.59313077939234,53.36856010568032,-9.775429326287977
ED 7,99.00%,169,87,2,7,2,AD   80,80007,267,89,176,-87,33.33333333333333,65.91760299625467,-32.58426966292134
ED 8,99.00%,403,214,9,28,14,AD   80,80008,668,223,431,-208,33.38323353293413,64.52095808383234,-31.137724550898213
ED 9,99.00%,159,102,3,9,3,AD   80,80009,276,105,168,-63,38.04347826086957,60.86956521739131,-22.826086956521742
ED 10,99.00%,235,251,21,13,8,AD   80,80010,528,272,248,24,51.515151515151516,46.96969696969697,4.545454545454547
ED 11,99.00%,333,205,13,18,8,AD   80,80011,577,218,351,-133,37.78162911611785,60.831889081455806,-23.050259965337958
ED 12,99.00%,446,226,16,38,4,AD   80,80012,730,242,484,-242,33.15068493150685,66.3013698630137,-33.15068493150685
ED 13,99.00%,439,216,10,28,9,AD   80,80013,702,226,467,-241,32.193732193732195,66.52421652421653,-34.33048433048433
ED 14,99.00%,421,140,10,34,9,AD   80,80014,614,150,455,-305,24.429967426710096,74.1042345276873,-49.674267100977204
ED 15,99.00%,497,180,10,18,9,AD   80,80015,714,190,515,-325,26.610644257703083,72.12885154061624,-45.51820728291315
ED 16,99.00%,386,198,21,26,15,AD   80,80016,646,219,412,-193,33.90092879256966,63.77708978328174,-29.87616099071208
ED 17,99.00%,476,227,13,25,19,AD   80,80017,760,240,501,-261,31.57894736842105,65.92105263157895,-34.34210526315789
ED 18,99.00%,300,257,19,10,2,AD   80,80018,588,276,310,-34,46.93877551020408,52.721088435374156,-5.782312925170075
ED 19,99.00%,213,237,21,18,18,AD   80,80019,507,258,231,27,50.887573964497044,45.562130177514796,5.325443786982248
ED 20,99.00%,329,472,23,20,21,AD   80,80020,865,495,349,146,57.22543352601156,40.346820809248555,16.878612716763
ED 21,99.00%,372,169,10,38,15,AD   80,80021,604,179,410,-231,29.635761589403977,67.88079470198676,-38.24503311258278
ED 22,99.00%,267,116,9,7,3,AD   80,80022,402,125,274,-149,31.094527363184078,68.1592039800995,-37.06467661691543
ED 23,99.00%,341,409,30,22,17,AD   80,80023,819,439,363,76,53.6019536019536,44.32234432234432,9.279609279609282
ED 24,99.00%,366,201,26,20,7,AD   80,80024,620,227,386,-159,36.612903225806456,62.25806451612903,-25.645161290322577
ED 25,99.00%,215,114,7,9,4,AD   80,80025,349,121,224,-103,34.67048710601719,64.18338108882521,-29.512893982808023
ED 26,99.00%,497,212,15,19,7,AD   80,80026,750,227,516,-289,30.266666666666666,68.8,-38.53333333333333
ED 27,99.00%,181,35,5,3,1,AD   80,80027,225,40,184,-144,17.77777777777778,81.77777777777779,-64.0
ED 28,99.00%,84,17,0,2,0,AD   80,80028,103,17,86,-69,16.50485436893204,83.49514563106796,-66.99029126213591
ED 29,99.00%,442,148,17,10,19,AD   80,80029,636,165,452,-287,25.943396226415093,71.0691823899371,-45.12578616352201
ED 30,87.50%,462,171,11,21,23,AD   80,80030,688,182,483,-301,26.453488372093027,70.20348837209302,-43.74999999999999
ED 31,99.00%,250,85,8,2,3,AD   80,80031,348,93,252,-159,26.72413793103448,72.41379310344827,-45.689655172413794
ED 32,99.00%,169,65,4,6,2,AD   80,80032,246,69,175,-106,28.04878048780488,71.13821138211382,-43.08943089430895
ED 33,99.00%,73,15,3,1,0,AD   80,80033,92,18,74,-56,19.565217391304348,80.43478260869566,-60.86956521739131
ED 34,99.00%,542,111,10,9,4,AD   80,80034,676,121,551,-430,17.899408284023668,81.50887573964496,-63.6094674556213
ED 35,99.00%,561,154,20,26,6,AD   80,80035,767,174,587,-413,22.685788787483702,76.53194263363756,-53.846153846153854
ED 36,99.00%,276,54,2,14,3,AD   80,80036,349,56,290,-234,16.045845272206304,83.0945558739255,-67.0487106017192
ED 37,99.00%,454,108,5,25,12,AD   80,80037,604,113,479,-366,18.70860927152318,79.30463576158941,-60.59602649006623
ED 38,99.00%,468,97,12,9,5,AD   80,80038,591,109,477,-368,18.44331641285956,80.71065989847716,-62.2673434856176
ED 39,99.00%,0,0,0,0,0,AD   80,80039,0,0,0,0,,,0.0
ED 40,99.00%,333,210,9,17,13,AD   80,80040,582,219,350,-131,37.628865979381445,60.13745704467354,-22.508591065292094
ED 41,99.00%,477,359,32,17,16,AD   80,80041,901,391,494,-103,43.39622641509434,54.827968923418425,-11.431742508324085
ED 42,99.00%,563,341,23,25,26,AD   80,80042,978,364,588,-224,37.21881390593047,60.122699386503065,-22.903885480572598
ED 43,87.50%,493,331,21,29,16,AD   80,80043,890,352,522,-170,39.550561797752806,58.651685393258425,-19.10112359550562
ED 44,87.50%,349,110,17,9,2,AD   80,80044,487,127,358,-231,26.07802874743326,73.51129363449692,-47.43326488706366
ED 45,99.00%,404,171,9,15,6,AD   80,80045,605,180,419,-239,29.75206611570248,69.25619834710743,-39.50413223140495
ED 46,99.00%,283,124,3,12,7,AD   80,80046,429,127,295,-168,29.603729603729604,68.76456876456876,-39.16083916083916
ED 47,87.50%,187,144,7,11,8,AD   80,80047,357,151,198,-47,42.296918767507,55.46218487394958,-13.16526610644258
ED 48,99.00%,269,183,12,7,5,AD   80,80048,476,195,276,-81,40.96638655462185,57.98319327731093,-17.016806722689083
ED 49,99.00%,312,129,12,14,7,AD   80,80049,474,141,326,-185,29.746835443037973,68.77637130801688,-39.029535864978904
ED 50,99.00%,361,107,16,15,14,AD   80,80050,513,123,376,-253,23.976608187134502,73.2943469785575,-49.317738791423
ED 51,99.00%,359,119,6,12,4,AD   80,80051,500,125,371,-246,25.0,74.2,-49.2
ED 52,99.00%,52,9,0,1,0,AD   80,80052,62,9,53,-44,14.516129032258066,85.48387096774194,-70.96774193548387
ED 53,99.00%,343,155,10,21,5,AD   80,80053,534,165,364,-199,30.89887640449438,68.16479400749064,-37.26591760299626
ED 54,99.00%,888,135,9,15,6,AD   80,80054,1053,144,903,-759,13.675213675213676,85.75498575498575,-72.07977207977208
ED 55,99.00%,388,187,10,15,9,AD   80,80055,609,197,403,-206,32.34811165845649,66.17405582922824,-33.82594417077175
ED 56,99.00%,362,193,10,18,22,AD   80,80056,605,203,380,-177,33.553719008264466,62.8099173553719,-29.256198347107436
ED 57,99.00%,480,194,17,24,28,AD   80,80057,743,211,504,-293,28.398384925975773,67.83310901749664,-39.43472409152086
ED 58,99.00%,256,134,7,10,3,AD   80,80058,410,141,266,-125,34.390243902439025,64.8780487804878,-30.487804878048777
ED 59,99.00%,235,104,6,11,12,AD   80,80059,368,110,246,-136,29.891304347826086,66.84782608695652,-36.95652173913043
ED 60,99.00%,84,120,8,6,8,AD   80,80060,226,128,90,38,56.63716814159292,39.823008849557525,16.8141592920354
ED 61,99.00%,1,1,0,0,0,AD   80,80061,2,1,1,0,50.0,50.0,0.0
ED 62,99.00%,102,49,4,4,13,AD   80,80062,172,53,106,-53,30.813953488372093,61.627906976744185,-30.813953488372093
ED 63,99.00%,110,76,0,6,2,AD   80,80063,194,76,116,-40,39.175257731958766,59.79381443298969,-20.618556701030926
ED 64,99.00%,28,7,1,0,0,AD   80,80064,36,8,28,-20,22.22222222222222,77.77777777777779,-55.555555555555564
ED 65,99.00%,0,0,0,0,0,AD   80,80065,0,0,0,0,,,0.0
ED 66,99.00%,0,0,0,0,0,AD   80,80066,0,0,0,0,,,0.0
ED 67,99.00%,0,0,0,0,0,AD   80,80067,0,0,0,0,,,0.0
ED 1,99.00%,323,176,14,8,9,AD   81,81001,530,190,331,-141,35.84905660377358,62.45283018867924,-26.60377358490566
ED 2,99.00%,427,201,16,23,7,AD   81,81002,674,217,450,-233,32.195845697329375,66.76557863501483,-34.56973293768546
ED 3,99.00%,225,155,9,9,6,AD   81,81003,404,164,234,-70,40.5940594059406,57.920792079207914,-17.326732673267315
ED 4,99.00%,256,84,4,8,1,AD   81,81004,353,88,264,-176,24.929178470254957,74.78753541076487,-49.85835694050992
ED 5,99.00%,236,157,10,23,12,AD   81,81005,438,167,259,-92,38.12785388127854,59.1324200913242,-21.00456621004566
ED 6,99.00%,391,192,11,18,2,AD   81,81006,614,203,409,-206,33.06188925081433,66.61237785016286,-33.550488599348526
ED 7,99.00%,269,93,8,21,12,AD   81,81007,403,101,290,-189,25.06203473945409,71.96029776674938,-46.898263027295286
ED 8,99.00%,374,125,17,25,23,AD   81,81008,564,142,399,-257,25.177304964539005,70.74468085106383,-45.56737588652483
ED 9,99.00%,300,146,9,22,8,AD   81,81009,485,155,322,-167,31.958762886597935,66.39175257731958,-34.43298969072164
ED 10,99.00%,449,241,19,31,13,AD   81,81010,753,260,480,-220,34.528552456839314,63.745019920318725,-29.21646746347941
ED 11,99.00%,583,289,19,42,24,AD   81,81011,957,308,625,-317,32.18390804597701,65.30825496342739,-33.124346917450374
ED 12,99.00%,306,181,21,25,4,AD   81,81012,537,202,331,-129,37.61638733705773,61.63873370577281,-24.022346368715077
ED 13,99.00%,49,31,1,6,2,AD   81,81013,89,32,55,-23,35.95505617977528,61.79775280898876,-25.842696629213478
ED 14,80.00%,524,188,14,39,14,AD   81,81014,779,202,563,-361,25.930680359435172,72.27214377406932,-46.34146341463415
ED 15,80.00%,454,102,11,36,6,AD   81,81015,609,113,490,-377,18.555008210180624,80.45977011494253,-61.904761904761905
ED 16,80.00%,325,87,10,26,12,AD   81,81016,460,97,351,-254,21.086956521739133,76.30434782608695,-55.21739130434782
ED 17,99.00%,741,256,24,81,30,AD   81,81017,1132,280,822,-542,24.73498233215548,72.6148409893993,-47.879858657243815
ED 18,99.00%,408,106,10,6,4,AD   81,81018,534,116,414,-298,21.722846441947567,77.52808988764045,-55.80524344569288
ED 19,99.00%,669,157,9,57,17,AD   81,81019,909,166,726,-560,18.26182618261826,79.86798679867987,-61.6061606160616
ED 20,99.00%,475,116,16,56,10,AD   81,81020,673,132,531,-399,19.61367013372957,78.90044576523032,-59.286775631500745
ED 21,99.00%,588,151,10,85,21,AD   81,81021,855,161,673,-512,18.83040935672515,78.71345029239765,-59.883040935672504
ED 22,99.00%,585,217,10,46,14,AD   81,81022,872,227,631,-404,26.03211009174312,72.36238532110092,-46.330275229357795
ED 23,99.00%,489,128,15,50,6,AD   81,81023,688,143,539,-396,20.78488372093023,78.34302325581395,-57.558139534883715
ED 24,99.00%,393,86,10,10,6,AD   81,81024,505,96,403,-307,19.00990099009901,79.8019801980198,-60.79207920792079
ED 25,99.00%,227,141,5,16,11,AD   81,81025,400,146,243,-97,36.5,60.75000000000001,-24.250000000000007
ED 26,99.00%,686,193,21,60,24,AD   81,81026,984,214,746,-532,21.747967479674795,75.8130081300813,-54.0650406504065
ED 27,80.00%,669,144,8,34,14,AD   81,81027,869,152,703,-551,17.491369390103568,80.897583429229,-63.40621403912543
ED 28,99.00%,832,198,13,46,17,AD   81,81028,1106,211,878,-667,19.077757685352623,79.38517179023508,-60.307414104882454
ED 29,99.00%,710,250,16,53,29,AD   81,81029,1058,266,763,-497,25.14177693761815,72.117202268431,-46.975425330812854
ED 30,99.00%,568,257,12,46,22,AD   81,81030,905,269,614,-345,29.723756906077348,67.84530386740332,-38.12154696132597
ED 31,99.00%,772,280,12,44,16,AD   81,81031,1124,292,816,-524,25.97864768683274,72.59786476868328,-46.619217081850536
ED 32,99.00%,482,211,13,45,14,AD   81,81032,765,224,527,-303,29.28104575163399,68.88888888888889,-39.607843137254896
ED 33,99.00%,310,98,11,13,10,AD   81,81033,442,109,323,-214,24.660633484162897,73.07692307692307,-48.416289592760165
ED 34,99.00%,631,142,15,36,11,AD   81,81034,835,157,667,-510,18.802395209580837,79.88023952095809,-61.07784431137725
ED 35,99.00%,573,161,18,42,13,AD   81,81035,807,179,615,-436,22.18091697645601,76.2081784386617,-54.02726146220569
ED 36,99.00%,368,140,19,31,11,AD   81,81036,569,159,399,-240,27.943760984182774,70.12302284710017,-42.1792618629174
ED 37,99.00%,599,217,21,49,20,AD   81,81037,906,238,648,-410,26.269315673289185,71.52317880794702,-45.253863134657834
ED 38,99.00%,386,174,26,31,20,AD   81,81038,637,200,417,-217,31.39717425431711,65.46310832025117,-34.06593406593406
ED 39,99.00%,453,191,18,35,13,AD   81,81039,710,209,488,-279,29.43661971830986,68.73239436619718,-39.29577464788733
ED 40,99.00%,393,203,20,32,15,AD   81,81040,663,223,425,-202,33.63499245852187,64.1025641025641,-30.46757164404223
ED 41,99.00%,272,301,27,18,16,AD   81,81041,634,328,290,38,51.73501577287066,45.74132492113564,5.993690851735018
ED 42,99.00%,294,307,22,43,20,AD   81,81042,686,329,337,-8,47.95918367346938,49.12536443148688,-1.1661807580174965
ED 43,99.00%,400,352,40,31,10,AD   81,81043,833,392,431,-39,47.05882352941176,51.7406962785114,-4.6818727490996395
ED 44,99.00%,661,125,13,16,7,AD   81,81044,822,138,677,-539,16.78832116788321,82.36009732360098,-65.57177615571777
ED 45,99.00%,406,194,29,29,7,AD   81,81045,665,223,435,-212,33.53383458646616,65.41353383458647,-31.87969924812031
ED 46,99.00%,249,60,3,26,6,AD   81,81046,344,63,275,-212,18.313953488372093,79.94186046511628,-61.627906976744185
ED 47,99.00%,435,218,15,15,16,AD   81,81047,699,233,450,-217,33.33333333333333,64.37768240343348,-31.044349070100154
ED 48,99.00%,565,207,23,25,6,AD   81,81048,826,230,590,-360,27.845036319612593,71.42857142857143,-43.58353510895884
ED 49,99.00%,428,150,13,22,7,AD   81,81049,620,163,450,-287,26.29032258064516,72.58064516129032,-46.29032258064516
ED 50,99.00%,365,181,10,15,8,AD   81,81050,579,191,380,-189,32.98791018998273,65.63039723661485,-32.64248704663213
ED 51,99.00%,430,127,12,25,10,AD   81,81051,604,139,455,-316,23.013245033112582,75.33112582781457,-52.31788079470199
ED 52,99.00%,449,72,10,11,1,AD   81,81052,543,82,460,-378,15.101289134438305,84.71454880294658,-69.61325966850828
ED 53,99.00%,447,238,20,44,16,AD   81,81053,765,258,491,-233,33.72549019607843,64.18300653594771,-30.45751633986928
ED 54,99.00%,621,253,21,60,12,AD   81,81054,967,274,681,-407,28.335056876938985,70.42399172699069,-42.08893485005171
ED 55,99.00%,148,55,7,10,4,AD   81,81055,224,62,158,-96,27.67857142857143,70.53571428571429,-42.85714285714286
ED 56,99.00%,330,124,14,37,22,AD   81,81056,527,138,367,-229,26.185958254269448,69.63946869070209,-43.45351043643264
ED 57,99.00%,412,75,2,12,9,AD   81,81057,510,77,424,-347,15.098039215686274,83.13725490196079,-68.03921568627452
ED 58,99.00%,409,103,8,18,2,AD   81,81058,540,111,427,-316,20.555555555555554,79.07407407407408,-58.51851851851852
ED 59,99.00%,378,79,1,6,3,AD   81,81059,467,80,384,-304,17.130620985010705,82.22698072805139,-65.09635974304068
ED 60,80.00%,0,0,0,0,0,AD   81,81060,0,0,0,0,,,0.0
ED 61,99.00%,0,0,0,0,0,AD   81,81061,0,0,0,0,,,0.0
ED 62,99.00%,0,0,0,0,0,AD   81,81062,0,0,0,0,,,0.0
ED 63,99.00%,1,0,0,0,0,AD   81,81063,1,0,1,-1,0.0,100.0,-100.0
ED 1,99.00%,295,557,50,19,8,AD   82,82001,929,607,314,293,65.33907427341227,33.79978471474704,31.539289558665224
ED 2,99.00%,110,223,21,4,2,AD   82,82002,360,244,114,130,67.77777777777779,31.666666666666664,36.11111111111112
ED 3,99.00%,345,326,32,10,10,AD   82,82003,723,358,355,3,49.51590594744122,49.100968188105114,0.4149377593361052
ED 4,99.00%,338,335,23,17,4,AD   82,82004,717,358,355,3,49.930264993026505,49.5118549511855,0.41841004184100683
ED 5,99.00%,240,287,26,15,6,AD   82,82005,574,313,255,58,54.52961672473867,44.42508710801394,10.104529616724733
ED 6,99.00%,220,511,21,13,3,AD   82,82006,768,532,233,299,69.27083333333334,30.338541666666668,38.93229166666667
ED 7,99.00%,323,261,31,12,7,AD   82,82007,634,292,335,-43,46.05678233438486,52.83911671924291,-6.782334384858046
ED 8,99.00%,277,325,24,17,13,AD   82,82008,656,349,294,55,53.20121951219512,44.81707317073171,8.384146341463406
ED 9,99.00%,390,292,26,19,4,AD   82,82009,731,318,409,-91,43.50205198358413,55.95075239398085,-12.448700410396718
ED 10,99.00%,490,301,27,25,3,AD   82,82010,846,328,515,-187,38.77068557919622,60.87470449172577,-22.104018912529554
ED 11,99.00%,377,239,21,17,7,AD   82,82011,661,260,394,-134,39.334341906202724,59.60665658093798,-20.272314674735256
ED 12,99.00%,282,59,10,12,3,AD   82,82012,366,69,294,-225,18.852459016393443,80.32786885245902,-61.47540983606558
ED 13,99.00%,268,68,6,10,2,AD   82,82013,354,74,278,-204,20.903954802259886,78.53107344632768,-57.62711864406779
ED 14,99.00%,295,57,10,8,0,AD   82,82014,370,67,303,-236,18.10810810810811,81.89189189189189,-63.783783783783775
ED 15,99.00%,374,286,37,33,14,AD   82,82015,744,323,407,-84,43.413978494623656,54.704301075268816,-11.29032258064516
ED 16,99.00%,397,288,28,14,13,AD   82,82016,740,316,411,-95,42.7027027027027,55.54054054054054,-12.837837837837839
ED 17,99.00%,41,21,2,1,0,AD   82,82017,65,23,42,-19,35.38461538461539,64.61538461538461,-29.230769230769226
ED 18,99.00%,303,425,42,20,8,AD   82,82018,798,467,323,144,58.521303258145366,40.476190476190474,18.04511278195489
ED 19,99.00%,301,480,32,17,7,AD   82,82019,837,512,318,194,61.17084826762246,37.992831541218635,23.178016726403825
ED 20,99.00%,329,600,48,17,4,AD   82,82020,998,648,346,302,64.92985971943888,34.66933867735471,30.26052104208417
ED 21,99.00%,217,427,38,8,8,AD   82,82021,698,465,225,240,66.6189111747851,32.23495702005731,34.38395415472779
ED 22,99.00%,177,325,22,8,4,AD   82,82022,536,347,185,162,64.73880597014924,34.51492537313433,30.22388059701491
ED 23,99.00%,198,297,27,10,4,AD   82,82023,536,324,208,116,60.447761194029844,38.80597014925373,21.641791044776113
ED 24,99.00%,182,255,13,16,4,AD   82,82024,470,268,198,70,57.02127659574469,42.12765957446808,14.893617021276604
ED 25,99.00%,491,259,24,27,10,AD   82,82025,811,283,518,-235,34.895191122071516,63.871763255240445,-28.97657213316893
ED 26,99.00%,299,217,24,23,9,AD   82,82026,572,241,322,-81,42.13286713286713,56.29370629370629,-14.16083916083916
ED 27,99.00%,273,255,18,23,11,AD   82,82027,580,273,296,-23,47.06896551724138,51.03448275862069,-3.9655172413793096
ED 28,99.00%,510,325,25,27,9,AD   82,82028,896,350,537,-187,39.0625,59.93303571428571,-20.870535714285708
ED 29,99.00%,435,253,34,34,8,AD   82,82029,764,287,469,-182,37.56544502617801,61.38743455497382,-23.82198952879581
ED 30,85.71%,361,197,26,22,8,AD   82,82030,614,223,383,-160,36.31921824104234,62.37785016286645,-26.05863192182411
ED 31,85.71%,274,239,20,26,14,AD   82,82031,573,259,300,-41,45.20069808027923,52.35602094240838,-7.155322862129147
ED 32,85.71%,351,347,24,37,9,AD   82,82032,768,371,388,-17,48.30729166666667,50.520833333333336,-2.2135416666666643
ED 33,99.00%,326,312,16,22,10,AD   82,82033,686,328,348,-20,47.8134110787172,50.72886297376093,-2.9154518950437307
ED 34,99.00%,282,169,19,18,6,AD   82,82034,494,188,300,-112,38.05668016194332,60.72874493927125,-22.672064777327932
ED 35,99.00%,141,83,7,7,4,AD   82,82035,242,90,148,-58,37.1900826446281,61.15702479338842,-23.966942148760324
ED 36,99.00%,351,208,15,15,23,AD   82,82036,612,223,366,-143,36.43790849673202,59.80392156862745,-23.36601307189543
ED 37,99.00%,13,2,0,2,0,AD   82,82037,17,2,15,-13,11.76470588235294,88.23529411764706,-76.47058823529412
ED 38,99.00%,400,328,28,23,19,AD   82,82038,798,356,423,-67,44.611528822055135,53.00751879699248,-8.395989974937343
ED 39,99.00%,309,242,23,25,9,AD   82,82039,608,265,334,-69,43.58552631578947,54.93421052631579,-11.348684210526315
ED 40,99.00%,335,166,11,24,20,AD   82,82040,556,177,359,-182,31.83453237410072,64.568345323741,-32.73381294964028
ED 41,99.00%,508,433,33,45,11,AD   82,82041,1030,466,553,-87,45.24271844660194,53.689320388349515,-8.446601941747574
ED 42,99.00%,484,455,30,47,14,AD   82,82042,1030,485,531,-46,47.0873786407767,51.553398058252434,-4.466019417475735
ED 43,99.00%,208,236,13,15,4,AD   82,82043,476,249,223,26,52.3109243697479,46.84873949579832,5.462184873949582
ED 44,85.71%,223,189,18,13,7,AD   82,82044,450,207,236,-29,46.0,52.44444444444445,-6.44444444444445
ED 45,99.00%,4,2,0,0,0,AD   82,82045,6,2,4,-2,33.33333333333333,66.66666666666666,-33.33333333333333
ED 46,99.00%,678,92,16,27,4,AD   82,82046,817,108,705,-597,13.219094247246021,86.29130966952265,-73.07221542227663
ED 47,99.00%,564,76,7,14,6,AD   82,82047,667,83,578,-495,12.443778110944528,86.65667166416792,-74.21289355322338
ED 48,99.00%,801,100,11,29,10,AD   82,82048,951,111,830,-719,11.67192429022082,87.27655099894848,-75.60462670872766
ED 49,99.00%,692,92,6,18,2,AD   82,82049,810,98,710,-612,12.098765432098766,87.65432098765432,-75.55555555555554
ED 50,99.00%,593,64,5,17,6,AD   82,82050,685,69,610,-541,10.072992700729927,89.05109489051095,-78.97810218978103
ED 51,99.00%,607,45,10,18,2,AD   82,82051,682,55,625,-570,8.064516129032258,91.64222873900293,-83.57771260997067
ED 52,99.00%,1,2,0,0,0,AD   82,82052,3,2,1,1,66.66666666666666,33.33333333333333,33.33333333333333
ED 53,99.00%,109,94,7,8,2,AD   82,82053,220,101,117,-16,45.909090909090914,53.18181818181819,-7.272727272727273
ED 54,99.00%,842,98,8,34,5,AD   82,82054,987,106,876,-770,10.739614994934144,88.75379939209726,-78.01418439716312
ED 55,99.00%,747,135,18,29,6,AD   82,82055,935,153,776,-623,16.363636363636363,82.99465240641712,-66.63101604278076
ED 56,99.00%,672,90,10,18,1,AD   82,82056,791,100,690,-590,12.64222503160556,87.23135271807838,-74.58912768647282
ED 57,99.00%,798,124,4,28,8,AD   82,82057,962,128,826,-698,13.305613305613306,85.86278586278586,-72.55717255717255
ED 58,99.00%,824,79,13,24,3,AD   82,82058,943,92,848,-756,9.75609756097561,89.92576882290561,-80.16967126193
ED 59,99.00%,822,106,12,22,6,AD   82,82059,968,118,844,-726,12.190082644628099,87.19008264462809,-75.0
ED 60,99.00%,740,109,7,21,10,AD   82,82060,887,116,761,-645,13.077790304396844,85.79481397970687,-72.71702367531003
ED 61,99.00%,783,89,10,31,4,AD   82,82061,917,99,814,-715,10.79607415485278,88.76772082878954,-77.97164667393676
ED 62,99.00%,680,73,16,16,7,AD   82,82062,792,89,696,-607,11.237373737373737,87.87878787878788,-76.64141414141415
ED 63,99.00%,804,113,15,20,13,AD   82,82063,965,128,824,-696,13.264248704663212,85.38860103626943,-72.12435233160622
ED 64,99.00%,821,122,14,19,3,AD   82,82064,979,136,840,-704,13.891726251276811,85.80183861082737,-71.91011235955057
ED 65,99.00%,713,106,7,19,2,AD   82,82065,847,113,732,-619,13.34120425029516,86.42266824085006,-73.0814639905549
ED 66,99.00%,514,96,9,18,6,AD   82,82066,643,105,532,-427,16.329704510108865,82.73716951788491,-66.40746500777604
ED 67,99.00%,0,0,0,0,0,AD   82,82067,0,0,0,0,,,0.0
ED 68,99.00%,0,0,0,0,0,AD   82,82068,0,0,0,0,,,0.0
ED 69,99.00%,0,0,0,0,0,AD   82,82069,0,0,0,0,,,0.0
ED 70,99.00%,0,0,0,0,0,AD   82,82070,0,0,0,0,,,0.0
ED 71,99.00%,0,0,0,0,0,AD   82,82071,0,0,0,0,,,0.0
ED 72,99.00%,0,0,0,0,0,AD   82,82072,0,0,0,0,,,0.0
ED 73,99.00%,0,0,0,0,0,AD   82,82073,0,0,0,0,,,0.0
ED 74,99.00%,0,0,0,0,0,AD   82,82074,0,0,0,0,,,0.0
ED 75,99.00%,0,0,0,0,0,AD   82,82075,0,0,0,0,,,0.0
ED 76,99.00%,0,0,0,0,0,AD   82,82076,0,0,0,0,,,0.0
ED 77,99.00%,0,0,0,0,0,AD   82,82077,0,0,0,0,,,0.0
ED 78,99.00%,0,0,0,0,0,AD   82,82078,0,0,0,0,,,0.0
ED 79,99.00%,0,0,0,0,0,AD   82,82079,0,0,0,0,,,0.0
ED 1,88.89%,632,87,9,5,1,AD   83,83001,734,96,637,-541,13.079019073569482,86.78474114441417,-73.70572207084469
ED 2,88.89%,620,66,14,20,8,AD   83,83002,728,80,640,-560,10.989010989010989,87.91208791208791,-76.92307692307692
ED 3,88.89%,582,96,17,17,5,AD   83,83003,717,113,599,-486,15.760111576011157,83.54253835425384,-67.78242677824268
ED 4,88.89%,496,52,6,16,2,AD   83,83004,572,58,512,-454,10.13986013986014,89.5104895104895,-79.37062937062936
ED 5,88.89%,527,49,11,9,3,AD   83,83005,599,60,536,-476,10.01669449081803,89.48247078464107,-79.46577629382304
ED 6,99.00%,714,69,11,17,6,AD   83,83006,817,80,731,-651,9.791921664626683,89.47368421052632,-79.68176254589963
ED 7,99.00%,732,73,13,16,2,AD   83,83007,836,86,748,-662,10.287081339712918,89.47368421052632,-79.1866028708134
ED 8,99.00%,458,71,6,7,11,AD   83,83008,553,77,465,-388,13.924050632911392,84.08679927667269,-70.1627486437613
ED 9,99.00%,416,72,3,9,1,AD   83,83009,501,75,425,-350,14.97005988023952,84.83033932135729,-69.86027944111777
ED 10,99.00%,474,79,4,12,3,AD   83,83010,572,83,486,-403,14.51048951048951,84.96503496503497,-70.45454545454547
ED 11,99.00%,653,89,8,16,4,AD   83,83011,770,97,669,-572,12.597402597402596,86.88311688311688,-74.28571428571429
ED 12,99.00%,439,75,4,9,6,AD   83,83012,533,79,448,-369,14.821763602251407,84.05253283302065,-69.23076923076924
ED 13,99.00%,392,71,8,20,11,AD   83,83013,502,79,412,-333,15.737051792828685,82.07171314741036,-66.33466135458168
ED 14,99.00%,397,85,4,16,4,AD   83,83014,506,89,413,-324,17.588932806324113,81.62055335968378,-64.03162055335967
ED 15,99.00%,547,95,7,16,8,AD   83,83015,673,102,563,-461,15.156017830609212,83.6552748885587,-68.49925705794948
ED 16,99.00%,570,61,6,16,4,AD   83,83016,657,67,586,-519,10.197869101978691,89.19330289193303,-78.99543378995433
ED 17,99.00%,545,79,3,14,6,AD   83,83017,647,82,559,-477,12.673879443585781,86.39876352395672,-73.72488408037094
ED 18,99.00%,376,64,5,11,5,AD   83,83018,461,69,387,-318,14.967462039045554,83.94793926247289,-68.98047722342733
ED 19,99.00%,492,85,7,23,1,AD   83,83019,608,92,515,-423,15.131578947368421,84.70394736842105,-69.57236842105263
ED 20,99.00%,623,80,13,16,11,AD   83,83020,743,93,639,-546,12.516823687752353,86.00269179004037,-73.48586810228802
ED 21,99.00%,682,52,3,16,7,AD   83,83021,760,55,698,-643,7.236842105263158,91.84210526315789,-84.60526315789473
ED 22,99.00%,702,79,7,15,3,AD   83,83022,806,86,717,-631,10.669975186104217,88.95781637717121,-78.287841191067
ED 23,99.00%,801,78,7,17,9,AD   83,83023,912,85,818,-733,9.320175438596491,89.69298245614034,-80.37280701754385
ED 24,99.00%,514,60,5,13,3,AD   83,83024,595,65,527,-462,10.92436974789916,88.57142857142857,-77.6470588235294
ED 25,99.00%,709,57,12,15,7,AD   83,83025,800,69,724,-655,8.625,90.5,-81.875
ED 26,99.00%,578,74,9,17,3,AD   83,83026,681,83,595,-512,12.187958883994126,87.37151248164464,-75.18355359765052
ED 27,99.00%,396,77,14,8,2,AD   83,83027,497,91,404,-313,18.30985915492958,81.28772635814889,-62.977867203219304
ED 28,99.00%,421,54,3,10,1,AD   83,83028,489,57,431,-374,11.65644171779141,88.13905930470347,-76.48261758691206
ED 29,99.00%,356,48,7,7,3,AD   83,83029,421,55,363,-308,13.064133016627078,86.22327790973871,-73.15914489311163
ED 30,99.00%,482,113,4,17,7,AD   83,83030,623,117,499,-382,18.780096308186195,80.09630818619583,-61.31621187800963
ED 31,99.00%,494,96,8,19,3,AD   83,83031,620,104,513,-409,16.7741935483871,82.74193548387096,-65.96774193548386
ED 32,99.00%,628,81,6,16,3,AD   83,83032,734,87,644,-557,11.852861035422343,87.73841961852861,-75.88555858310627
ED 33,99.00%,609,69,3,18,4,AD   83,83033,703,72,627,-555,10.241820768136558,89.1891891891892,-78.94736842105263
ED 34,99.00%,537,81,5,13,6,AD   83,83034,642,86,550,-464,13.395638629283487,85.66978193146417,-72.27414330218069
ED 35,99.00%,588,83,14,13,3,AD   83,83035,701,97,601,-504,13.837375178316691,85.73466476462197,-71.89728958630528
ED 36,99.00%,399,44,2,13,2,AD   83,83036,460,46,412,-366,10.0,89.56521739130436,-79.56521739130436
ED 37,99.00%,379,28,1,14,5,AD   83,83037,427,29,393,-364,6.791569086651054,92.03747072599532,-85.24590163934427
ED 38,99.00%,381,75,7,12,4,AD   83,83038,479,82,393,-311,17.118997912317326,82.04592901878914,-64.92693110647181
ED 39,99.00%,487,59,5,10,2,AD   83,83039,563,64,497,-433,11.367673179396093,88.27708703374778,-76.90941385435168
ED 40,99.00%,255,42,4,7,2,AD   83,83040,310,46,262,-216,14.838709677419354,84.51612903225806,-69.6774193548387
ED 41,88.89%,740,53,3,18,4,AD   83,83041,818,56,758,-702,6.845965770171149,92.66503667481662,-85.81907090464547
ED 42,99.00%,302,44,7,5,1,AD   83,83042,359,51,307,-256,14.206128133704734,85.51532033426183,-71.30919220055709
ED 43,88.89%,468,54,8,15,5,AD   83,83043,550,62,483,-421,11.272727272727273,87.81818181818181,-76.54545454545453
ED 44,88.89%,802,69,13,19,4,AD   83,83044,907,82,821,-739,9.040793825799339,90.51819184123484,-81.4773980154355
ED 45,99.00%,417,33,5,8,4,AD   83,83045,467,38,425,-387,8.137044967880087,91.00642398286938,-82.86937901498929
ED 46,99.00%,654,114,17,18,7,AD   83,83046,810,131,672,-541,16.17283950617284,82.96296296296296,-66.79012345679013
ED 47,99.00%,602,70,8,10,4,AD   83,83047,694,78,612,-534,11.239193083573488,88.18443804034582,-76.94524495677234
ED 48,99.00%,699,76,8,15,1,AD   83,83048,799,84,714,-630,10.513141426783479,89.36170212765957,-78.84856070087609
ED 49,99.00%,319,51,6,10,2,AD   83,83049,388,57,329,-272,14.690721649484537,84.79381443298969,-70.10309278350516
ED 50,99.00%,345,80,11,12,2,AD   83,83050,450,91,357,-266,20.22222222222222,79.33333333333333,-59.11111111111111
ED 51,99.00%,258,55,9,14,3,AD   83,83051,339,64,272,-208,18.87905604719764,80.23598820058997,-61.356932153392336
ED 52,99.00%,383,67,0,9,1,AD   83,83052,460,67,392,-325,14.565217391304348,85.21739130434783,-70.65217391304348
ED 53,99.00%,395,27,5,13,0,AD   83,83053,440,32,408,-376,7.2727272727272725,92.72727272727272,-85.45454545454545
ED 54,99.00%,565,81,4,11,3,AD   83,83054,664,85,576,-491,12.801204819277109,86.74698795180723,-73.94578313253012
ED 55,99.00%,0,0,0,0,0,AD   83,83055,0,0,0,0,,,0.0
ED 56,99.00%,0,0,0,0,0,AD   83,83056,0,0,0,0,,,0.0
ED 57,99.00%,0,0,0,0,0,AD   83,83057,0,0,0,0,,,0.0
ED 58,99.00%,253,43,4,7,4,AD   83,83058,311,47,260,-213,15.112540192926044,83.60128617363344,-68.48874598070739
ED 59,99.00%,71,4,0,1,0,AD   83,83059,76,4,72,-68,5.263157894736842,94.73684210526315,-89.47368421052632
ED 60,99.00%,2,0,0,0,0,AD   83,83060,2,0,2,-2,0.0,100.0,-100.0
ED 61,99.00%,201,30,5,3,0,AD   83,83061,239,35,204,-169,14.644351464435147,85.35564853556485,-70.7112970711297
ED 62,99.00%,207,30,1,3,3,AD   83,83062,244,31,210,-179,12.704918032786885,86.0655737704918,-73.36065573770492
ED 63,88.89%,274,16,2,6,0,AD   83,83063,298,18,280,-262,6.0402684563758395,93.95973154362416,-87.91946308724832
ED 64,88.89%,66,12,2,5,0,AD   83,83064,85,14,71,-57,16.470588235294116,83.52941176470588,-67.05882352941177
ED 65,88.89%,59,14,1,3,0,AD   83,83065,77,15,62,-47,19.480519480519483,80.51948051948052,-61.03896103896104
ED 66,99.00%,126,9,2,2,0,AD   83,83066,139,11,128,-117,7.913669064748201,92.08633093525181,-84.1726618705036
ED 67,99.00%,101,8,1,2,0,AD   83,83067,112,9,103,-94,8.035714285714286,91.96428571428571,-83.92857142857142
ED 1,99.00%,478,209,10,7,5,AD   84,84001,709,219,485,-266,30.888575458392104,68.4062059238364,-37.51763046544429
ED 2,99.00%,146,62,4,7,1,AD   84,84002,220,66,153,-87,30.0,69.54545454545455,-39.54545454545455
ED 3,99.00%,377,213,8,11,2,AD   84,84003,611,221,388,-167,36.17021276595745,63.50245499181669,-27.33224222585924
ED 4,99.00%,432,203,12,15,12,AD   84,84004,674,215,447,-232,31.899109792284868,66.32047477744807,-34.4213649851632
ED 5,99.00%,417,177,9,13,4,AD   84,84005,620,186,430,-244,30.0,69.35483870967742,-39.35483870967742
ED 6,99.00%,420,215,10,13,7,AD   84,84006,665,225,433,-208,33.83458646616541,65.11278195488723,-31.278195488721813
ED 7,99.00%,307,161,12,20,9,AD   84,84007,509,173,327,-154,33.988212180746565,64.24361493123773,-30.255402750491164
ED 8,99.00%,477,171,9,14,6,AD   84,84008,677,180,491,-311,26.587887740029544,72.52584933530281,-45.937961595273265
ED 9,99.00%,290,76,11,18,7,AD   84,84009,402,87,308,-221,21.641791044776117,76.61691542288557,-54.975124378109456
ED 10,99.00%,400,156,12,20,2,AD   84,84010,590,168,420,-252,28.474576271186443,71.1864406779661,-42.71186440677966
ED 11,99.00%,396,147,9,16,7,AD   84,84011,575,156,412,-256,27.1304347826087,71.65217391304348,-44.52173913043478
ED 12,99.00%,345,132,8,34,14,AD   84,84012,533,140,379,-239,26.26641651031895,71.10694183864915,-44.8405253283302
ED 13,99.00%,293,88,7,20,2,AD   84,84013,410,95,313,-218,23.170731707317074,76.34146341463415,-53.170731707317074
ED 14,99.00%,298,76,3,22,10,AD   84,84014,409,79,320,-241,19.315403422982886,78.239608801956,-58.92420537897311
ED 15,83.33%,95,43,2,7,1,AD   84,84015,148,45,102,-57,30.405405405405407,68.91891891891892,-38.513513513513516
ED 16,83.33%,149,25,4,12,9,AD   84,84016,199,29,161,-132,14.572864321608039,80.90452261306532,-66.33165829145729
ED 17,99.00%,671,170,17,28,3,AD   84,84017,889,187,699,-512,21.034870641169853,78.62767154105737,-57.592800899887514
ED 18,99.00%,406,150,13,10,5,AD   84,84018,584,163,416,-253,27.910958904109588,71.23287671232876,-43.32191780821917
ED 19,99.00%,312,81,7,10,9,AD   84,84019,419,88,322,-234,21.002386634844868,76.84964200477327,-55.847255369928405
ED 20,99.00%,420,122,7,16,2,AD   84,84020,567,129,436,-307,22.75132275132275,76.89594356261023,-54.14462081128748
ED 21,99.00%,278,80,7,12,4,AD   84,84021,381,87,290,-203,22.83464566929134,76.11548556430446,-53.28083989501312
ED 22,99.00%,401,123,17,14,4,AD   84,84022,559,140,415,-275,25.044722719141323,74.23971377459749,-49.19499105545617
ED 23,99.00%,181,76,6,15,5,AD   84,84023,283,82,196,-114,28.975265017667844,69.25795053003534,-40.2826855123675
ED 24,99.00%,198,89,6,13,6,AD   84,84024,312,95,211,-116,30.448717948717945,67.62820512820514,-37.1794871794872
ED 25,99.00%,446,187,18,14,2,AD   84,84025,667,205,460,-255,30.73463268365817,68.96551724137932,-38.23088455772115
ED 26,99.00%,298,106,5,15,2,AD   84,84026,426,111,313,-202,26.056338028169012,73.47417840375586,-47.41784037558685
ED 27,99.00%,88,31,2,6,3,AD   84,84027,130,33,94,-61,25.384615384615383,72.3076923076923,-46.92307692307692
ED 28,99.00%,470,180,13,13,2,AD   84,84028,678,193,483,-290,28.466076696165192,71.23893805309734,-42.772861356932154
ED 29,99.00%,513,155,14,35,8,AD   84,84029,725,169,548,-379,23.310344827586206,75.58620689655172,-52.27586206896551
ED 30,99.00%,339,112,14,9,6,AD   84,84030,480,126,348,-222,26.25,72.5,-46.25
ED 31,99.00%,407,142,7,14,5,AD   84,84031,575,149,421,-272,25.91304347826087,73.21739130434783,-47.30434782608695
ED 32,99.00%,369,127,4,9,5,AD   84,84032,514,131,378,-247,25.486381322957197,73.54085603112841,-48.05447470817121
ED 33,99.00%,212,58,11,9,1,AD   84,84033,291,69,221,-152,23.711340206185564,75.94501718213058,-52.233676975945016
ED 34,99.00%,409,132,15,22,2,AD   84,84034,580,147,431,-284,25.344827586206897,74.3103448275862,-48.96551724137931
ED 35,99.00%,367,136,6,11,3,AD   84,84035,523,142,378,-236,27.151051625239003,72.27533460803059,-45.124282982791584
ED 36,99.00%,391,98,8,21,3,AD   84,84036,521,106,412,-306,20.34548944337812,79.07869481765835,-58.733205374280224
ED 37,99.00%,364,92,7,20,0,AD   84,84037,483,99,384,-285,20.496894409937887,79.5031055900621,-59.00621118012422
ED 38,99.00%,305,147,16,21,2,AD   84,84038,491,163,326,-163,33.19755600814664,66.39511201629328,-33.19755600814664
ED 39,99.00%,235,101,17,18,2,AD   84,84039,373,118,253,-135,31.63538873994638,67.828418230563,-36.193029490616624
ED 40,99.00%,220,75,3,10,6,AD   84,84040,314,78,230,-152,24.840764331210192,73.24840764331209,-48.4076433121019
ED 41,99.00%,366,141,8,19,8,AD   84,84041,542,149,385,-236,27.490774907749078,71.03321033210332,-43.542435424354245
ED 42,99.00%,331,83,6,8,6,AD   84,84042,434,89,339,-250,20.506912442396313,78.11059907834101,-57.6036866359447
ED 43,99.00%,387,101,7,18,2,AD   84,84043,515,108,405,-297,20.97087378640777,78.64077669902912,-57.66990291262135
ED 44,99.00%,301,85,5,17,0,AD   84,84044,408,90,318,-228,22.058823529411764,77.94117647058823,-55.882352941176464
ED 45,99.00%,349,107,11,19,4,AD   84,84045,490,118,368,-250,24.081632653061224,75.10204081632654,-51.020408163265316
ED 46,99.00%,351,104,10,12,3,AD   84,84046,480,114,363,-249,23.75,75.625,-51.875
ED 47,99.00%,229,97,8,17,0,AD   84,84047,351,105,246,-141,29.914529914529915,70.08547008547008,-40.17094017094016
ED 48,99.00%,395,94,11,29,8,AD   84,84048,537,105,424,-319,19.553072625698324,78.95716945996276,-59.404096834264436
ED 49,99.00%,205,60,4,6,0,AD   84,84049,275,64,211,-147,23.272727272727273,76.72727272727272,-53.454545454545446
ED 50,99.00%,245,105,4,11,2,AD   84,84050,367,109,256,-147,29.70027247956403,69.75476839237056,-40.05449591280653
ED 51,99.00%,424,82,12,38,18,AD   84,84051,574,94,462,-368,16.376306620209057,80.48780487804879,-64.11149825783974
ED 52,99.00%,62,18,4,4,0,AD   84,84052,88,22,66,-44,25.0,75.0,-50.0
ED 53,99.00%,69,19,1,10,2,AD   84,84053,101,20,79,-59,19.801980198019802,78.21782178217822,-58.415841584158414
ED 54,99.00%,160,51,4,11,2,AD   84,84054,228,55,171,-116,24.12280701754386,75.0,-50.87719298245614
ED 55,99.00%,452,156,10,26,4,AD   84,84055,648,166,478,-312,25.617283950617285,73.76543209876543,-48.148148148148145
ED 56,99.00%,152,54,4,10,6,AD   84,84056,226,58,162,-104,25.663716814159294,71.68141592920354,-46.017699115044245
ED 57,99.00%,233,66,13,12,1,AD   84,84057,325,79,245,-166,24.307692307692307,75.38461538461539,-51.07692307692308
ED 58,99.00%,345,139,8,11,2,AD   84,84058,505,147,356,-209,29.108910891089106,70.49504950495049,-41.38613861386138
ED 59,99.00%,28,12,0,3,0,AD   84,84059,43,12,31,-19,27.906976744186046,72.09302325581395,-44.1860465116279
ED 60,99.00%,50,28,0,3,0,AD   84,84060,81,28,53,-25,34.5679012345679,65.4320987654321,-30.864197530864203
ED 61,99.00%,165,39,6,8,0,AD   84,84061,218,45,173,-128,20.642201834862387,79.35779816513761,-58.71559633027522
ED 62,99.00%,0,0,0,0,0,AD   84,84062,0,0,0,0,,,0.0
ED 63,83.33%,0,0,0,0,0,AD   84,84063,0,0,0,0,,,0.0
ED 64,99.00%,123,46,3,7,1,AD   84,84064,180,49,130,-81,27.22222222222222,72.22222222222221,-44.99999999999999
ED 65,99.00%,158,67,2,5,3,AD   84,84065,235,69,163,-94,29.361702127659573,69.36170212765957,-40.0
ED 66,99.00%,142,32,5,19,3,AD   84,84066,201,37,161,-124,18.407960199004975,80.09950248756219,-61.691542288557216
ED 67,99.00%,219,23,5,14,2,AD   84,84067,263,28,233,-205,10.646387832699618,88.59315589353612,-77.9467680608365
ED 1,99.00%,747,177,22,47,9,AD   85,85001,1002,199,794,-595,19.860279441117765,79.24151696606786,-59.381237524950095
ED 2,83.33%,492,188,15,26,8,AD   85,85002,729,203,518,-315,27.846364883401918,71.0562414266118,-43.20987654320989
ED 3,83.33%,367,179,7,12,7,AD   85,85003,572,186,379,-193,32.51748251748251,66.25874125874127,-33.741258741258754
ED 4,99.00%,409,185,14,21,7,AD   85,85004,636,199,430,-231,31.289308176100626,67.61006289308176,-36.320754716981135
ED 5,99.00%,588,179,8,25,13,AD   85,85005,813,187,613,-426,23.001230012300123,75.39975399753997,-52.39852398523985
ED 6,99.00%,319,115,8,13,1,AD   85,85006,456,123,332,-209,26.973684210526315,72.80701754385966,-45.83333333333334
ED 7,99.00%,288,96,3,3,5,AD   85,85007,395,99,291,-192,25.063291139240505,73.67088607594937,-48.607594936708864
ED 8,83.33%,184,69,4,3,3,AD   85,85008,263,73,187,-114,27.756653992395435,71.10266159695817,-43.346007604562736
ED 9,99.00%,453,193,22,18,13,AD   85,85009,699,215,471,-256,30.758226037195996,67.38197424892704,-36.62374821173104
ED 10,99.00%,294,85,6,16,4,AD   85,85010,405,91,310,-219,22.469135802469136,76.5432098765432,-54.07407407407406
ED 11,85.71%,354,97,8,6,2,AD   85,85011,467,105,360,-255,22.483940042826553,77.08779443254818,-54.603854389721626
ED 12,85.71%,307,92,4,10,1,AD   85,85012,414,96,317,-221,23.18840579710145,76.57004830917874,-53.38164251207729
ED 13,85.71%,379,112,9,14,7,AD   85,85013,521,121,393,-272,23.224568138195778,75.43186180422265,-52.20729366602687
ED 14,99.00%,428,93,3,13,3,AD   85,85014,540,96,441,-345,17.77777777777778,81.66666666666667,-63.88888888888889
ED 15,99.00%,731,105,9,26,4,AD   85,85015,875,114,757,-643,13.028571428571428,86.5142857142857,-73.48571428571428
ED 16,99.00%,437,93,8,15,3,AD   85,85016,556,101,452,-351,18.165467625899282,81.29496402877699,-63.129496402877706
ED 17,99.00%,360,112,12,14,4,AD   85,85017,502,124,374,-250,24.701195219123505,74.5019920318725,-49.800796812749
ED 18,99.00%,9,8,2,0,0,AD   85,85018,19,10,9,1,52.63157894736842,47.368421052631575,5.2631578947368425
ED 19,99.00%,379,123,6,14,11,AD   85,85019,533,129,393,-264,24.202626641651033,73.73358348968105,-49.530956848030016
ED 20,99.00%,399,103,5,14,0,AD   85,85020,521,108,413,-305,20.72936660268714,79.27063339731286,-58.54126679462573
ED 21,99.00%,485,141,11,19,21,AD   85,85021,677,152,504,-352,22.451994091580502,74.44608567208272,-51.994091580502214
ED 22,99.00%,485,176,12,25,9,AD   85,85022,707,188,510,-322,26.591230551626595,72.13578500707214,-45.54455445544555
ED 23,99.00%,240,91,5,10,2,AD   85,85023,348,96,250,-154,27.586206896551722,71.83908045977012,-44.252873563218394
ED 24,99.00%,171,73,6,8,3,AD   85,85024,261,79,179,-100,30.268199233716476,68.5823754789272,-38.31417624521073
ED 25,99.00%,370,94,7,12,2,AD   85,85025,485,101,382,-281,20.824742268041238,78.76288659793815,-57.938144329896915
ED 26,99.00%,280,90,4,5,0,AD   85,85026,379,94,285,-191,24.80211081794195,75.19788918205805,-50.3957783641161
ED 27,99.00%,216,73,5,9,3,AD   85,85027,306,78,225,-147,25.49019607843137,73.52941176470588,-48.03921568627452
ED 28,99.00%,553,164,13,24,7,AD   85,85028,761,177,577,-400,23.258869908015768,75.82128777923785,-52.56241787122208
ED 29,99.00%,431,165,11,23,2,AD   85,85029,632,176,454,-278,27.848101265822784,71.83544303797468,-43.9873417721519
ED 30,83.33%,265,111,5,10,5,AD   85,85030,396,116,275,-159,29.292929292929294,69.44444444444444,-40.15151515151515
ED 31,83.33%,329,103,5,14,0,AD   85,85031,451,108,343,-235,23.946784922394677,76.05321507760532,-52.10643015521064
ED 32,83.33%,264,92,11,13,5,AD   85,85032,385,103,277,-174,26.75324675324675,71.94805194805195,-45.194805194805205
ED 33,99.00%,221,71,7,15,1,AD   85,85033,315,78,236,-158,24.761904761904763,74.92063492063492,-50.158730158730165
ED 34,99.00%,344,97,10,13,1,AD   85,85034,465,107,357,-250,23.010752688172044,76.77419354838709,-53.76344086021504
ED 35,99.00%,423,162,8,11,4,AD   85,85035,608,170,434,-264,27.960526315789476,71.38157894736842,-43.421052631578945
ED 36,99.00%,438,169,17,29,3,AD   85,85036,656,186,467,-281,28.353658536585364,71.1890243902439,-42.83536585365854
ED 37,99.00%,320,112,7,11,1,AD   85,85037,451,119,331,-212,26.38580931263858,73.39246119733924,-47.00665188470066
ED 38,99.00%,0,1,0,0,0,AD   85,85038,1,1,0,1,100.0,0.0,100.0
ED 39,99.00%,489,174,12,20,1,AD   85,85039,696,186,509,-323,26.72413793103448,73.13218390804597,-46.4080459770115
ED 40,99.00%,284,105,12,19,1,AD   85,85040,421,117,303,-186,27.790973871733964,71.97149643705463,-44.18052256532066
ED 41,99.00%,455,177,6,13,3,AD   85,85041,654,183,468,-285,27.981651376146786,71.55963302752293,-43.57798165137615
ED 42,99.00%,325,103,10,4,4,AD   85,85042,446,113,329,-216,25.336322869955158,73.76681614349776,-48.43049327354261
ED 43,99.00%,389,123,12,22,14,AD   85,85043,560,135,411,-276,24.107142857142858,73.39285714285714,-49.28571428571428
ED 44,99.00%,329,143,5,9,1,AD   85,85044,487,148,338,-190,30.390143737166326,69.40451745379876,-39.014373716632434
ED 45,99.00%,297,144,12,10,5,AD   85,85045,468,156,307,-151,33.33333333333333,65.5982905982906,-32.264957264957275
ED 46,99.00%,469,116,9,18,6,AD   85,85046,618,125,487,-362,20.22653721682848,78.80258899676376,-58.576051779935284
ED 47,99.00%,181,85,6,7,0,AD   85,85047,279,91,188,-97,32.61648745519714,67.38351254480287,-34.76702508960573
ED 48,99.00%,222,87,8,9,1,AD   85,85048,327,95,231,-136,29.051987767584098,70.64220183486239,-41.590214067278296
ED 49,99.00%,214,113,11,9,2,AD   85,85049,349,124,223,-99,35.53008595988539,63.89684813753582,-28.36676217765043
ED 50,99.00%,343,140,9,11,6,AD   85,85050,509,149,354,-205,29.273084479371313,69.54813359528488,-40.27504911591357
ED 51,99.00%,868,55,11,26,5,AD   85,85051,965,66,894,-828,6.839378238341968,92.64248704663213,-85.80310880829016
ED 52,99.00%,776,137,19,23,5,AD   85,85052,960,156,799,-643,16.25,83.22916666666667,-66.97916666666667
ED 53,99.00%,513,52,7,11,4,AD   85,85053,587,59,524,-465,10.051107325383304,89.26746166950596,-79.21635434412266
ED 54,99.00%,337,114,9,18,3,AD   85,85054,481,123,355,-232,25.571725571725572,73.8045738045738,-48.232848232848234
ED 55,99.00%,0,0,0,0,0,AD   85,85055,0,0,0,0,,,0.0
ED 56,99.00%,0,0,0,0,0,AD   85,85056,0,0,0,0,,,0.0
ED 57,99.00%,0,0,0,0,0,AD   85,85057,0,0,0,0,,,0.0
ED 58,99.00%,0,0,0,0,0,AD   85,85058,0,0,0,0,,,0.0
ED 59,99.00%,0,0,0,0,0,AD   85,85059,0,0,0,0,,,0.0
ED 60,99.00%,0,0,0,0,0,AD   85,85060,0,0,0,0,,,0.0
ED 61,99.00%,0,0,0,0,0,AD   85,85061,0,0,0,0,,,0.0
ED 62,99.00%,0,0,0,0,0,AD   85,85062,0,0,0,0,,,0.0
ED 63,99.00%,0,0,0,0,0,AD   85,85063,0,0,0,0,,,0.0
ED 64,99.00%,0,0,0,0,0,AD   85,85064,0,0,0,0,,,0.0
ED 65,99.00%,0,0,0,0,0,AD   85,85065,0,0,0,0,,,0.0
ED 66,99.00%,0,0,0,0,0,AD   85,85066,0,0,0,0,,,0.0
ED 67,99.00%,0,0,0,0,0,AD   85,85067,0,0,0,0,,,0.0
ED 68,99.00%,0,0,0,0,0,AD   85,85068,0,0,0,0,,,0.0
ED 69,99.00%,0,0,0,0,0,AD   85,85069,0,0,0,0,,,0.0
ED 70,99.00%,0,0,0,0,0,AD   85,85070,0,0,0,0,,,0.0
ED 71,99.00%,0,0,0,0,0,AD   85,85071,0,0,0,0,,,0.0
ED 72,99.00%,0,0,0,0,0,AD   85,85072,0,0,0,0,,,0.0
ED 73,99.00%,0,0,0,0,0,AD   85,85073,0,0,0,0,,,0.0
ED 74,99.00%,0,0,0,0,0,AD   85,85074,0,0,0,0,,,0.0
ED 75,99.00%,0,0,0,0,0,AD   85,85075,0,0,0,0,,,0.0
ED 76,99.00%,0,0,0,0,0,AD   85,85076,0,0,0,0,,,0.0
ED 77,99.00%,0,0,0,0,0,AD   85,85077,0,0,0,0,,,0.0
ED 78,99.00%,0,0,0,0,0,AD   85,85078,0,0,0,0,,,0.0
ED 79,99.00%,0,0,0,0,0,AD   85,85079,0,0,0,0,,,0.0
ED 80,99.00%,0,0,0,0,0,AD   85,85080,0,0,0,0,,,0.0
ED 81,99.00%,0,0,0,0,0,AD   85,85081,0,0,0,0,,,0.0
ED 82,99.00%,0,0,0,0,0,AD   85,85082,0,0,0,0,,,0.0
ED 83,99.00%,0,0,0,0,0,AD   85,85083,0,0,0,0,,,0.0
ED 84,99.00%,43,8,2,0,0,AD   85,85084,53,10,43,-33,18.867924528301888,81.13207547169812,-62.26415094339623
ED 85,83.33%,12,9,0,0,0,AD   85,85085,21,9,12,-3,42.857142857142854,57.14285714285714,-14.285714285714285
ED 86,83.33%,1,5,1,0,0,AD   85,85086,7,6,1,5,85.71428571428571,14.285714285714285,71.42857142857142
ED 1,99.00%,338,151,7,8,2,AD   86,86001,506,158,346,-188,31.225296442687743,68.37944664031622,-37.154150197628475
ED 2,99.00%,422,168,10,14,5,AD   86,86002,619,178,436,-258,28.75605815831987,70.43618739903069,-41.68012924071081
ED 3,99.00%,46,17,0,3,2,AD   86,86003,68,17,49,-32,25.0,72.05882352941177,-47.05882352941177
ED 4,99.00%,339,151,7,8,4,AD   86,86004,509,158,347,-189,31.041257367387033,68.17288801571709,-37.13163064833006
ED 5,99.00%,324,184,11,11,2,AD   86,86005,532,195,335,-140,36.65413533834587,62.96992481203007,-26.315789473684205
ED 6,99.00%,305,170,6,10,5,AD   86,86006,496,176,315,-139,35.483870967741936,63.50806451612904,-28.024193548387103
ED 7,99.00%,445,207,10,7,7,AD   86,86007,676,217,452,-235,32.10059171597633,66.86390532544378,-34.76331360946745
ED 8,99.00%,301,172,10,15,5,AD   86,86008,503,182,316,-134,36.18290258449304,62.82306163021869,-26.640159045725646
ED 9,99.00%,486,230,16,15,2,AD   86,86009,749,246,501,-255,32.843791722296395,66.88918558077437,-34.04539385847797
ED 10,85.71%,335,103,12,5,8,AD   86,86010,463,115,340,-225,24.838012958963283,73.4341252699784,-48.59611231101511
ED 11,85.71%,278,131,10,9,3,AD   86,86011,431,141,287,-146,32.71461716937355,66.5893271461717,-33.87470997679815
ED 12,99.00%,388,178,5,11,2,AD   86,86012,584,183,399,-216,31.335616438356162,68.32191780821918,-36.98630136986302
ED 13,99.00%,363,256,13,13,7,AD   86,86013,652,269,376,-107,41.25766871165644,57.668711656441715,-16.411042944785272
ED 14,99.00%,292,155,5,4,4,AD   86,86014,460,160,296,-136,34.78260869565217,64.34782608695652,-29.565217391304344
ED 15,99.00%,266,100,6,3,4,AD   86,86015,379,106,269,-163,27.96833773087071,70.97625329815304,-43.007915567282325
ED 16,99.00%,414,187,13,7,21,AD   86,86016,642,200,421,-221,31.15264797507788,65.57632398753894,-34.42367601246106
ED 17,99.00%,287,105,3,10,1,AD   86,86017,406,108,297,-189,26.60098522167488,73.15270935960592,-46.551724137931046
ED 18,99.00%,362,190,11,3,5,AD   86,86018,571,201,365,-164,35.20140105078809,63.92294220665499,-28.721541155866895
ED 19,99.00%,307,162,9,16,2,AD   86,86019,496,171,323,-152,34.475806451612904,65.12096774193549,-30.645161290322584
ED 20,99.00%,302,132,5,11,6,AD   86,86020,456,137,313,-176,30.043859649122805,68.64035087719299,-38.59649122807018
ED 21,99.00%,323,186,11,3,2,AD   86,86021,525,197,326,-129,37.523809523809526,62.095238095238095,-24.57142857142857
ED 22,99.00%,293,132,9,7,5,AD   86,86022,446,141,300,-159,31.614349775784756,67.2645739910314,-35.65022421524664
ED 23,99.00%,296,127,6,14,8,AD   86,86023,451,133,310,-177,29.490022172949004,68.73614190687361,-39.24611973392461
ED 24,99.00%,256,175,8,7,2,AD   86,86024,448,183,263,-80,40.848214285714285,58.70535714285714,-17.857142857142854
ED 25,99.00%,222,183,8,6,2,AD   86,86025,421,191,228,-37,45.36817102137768,54.156769596199524,-8.788598574821847
ED 26,90.00%,338,193,10,9,2,AD   86,86026,552,203,347,-144,36.775362318840585,62.86231884057971,-26.086956521739125
ED 27,90.00%,261,134,5,11,2,AD   86,86027,413,139,272,-133,33.65617433414044,65.85956416464892,-32.20338983050848
ED 28,90.00%,257,110,11,17,3,AD   86,86028,398,121,274,-153,30.402010050251256,68.84422110552764,-38.44221105527638
ED 29,90.00%,248,123,7,12,4,AD   86,86029,394,130,260,-130,32.99492385786802,65.98984771573603,-32.99492385786802
ED 30,99.00%,350,205,10,16,9,AD   86,86030,590,215,366,-151,36.440677966101696,62.03389830508475,-25.593220338983052
ED 31,99.00%,408,134,11,16,4,AD   86,86031,573,145,424,-279,25.30541012216405,73.99650959860384,-48.69109947643979
ED 32,99.00%,336,105,5,14,4,AD   86,86032,464,110,350,-240,23.70689655172414,75.43103448275862,-51.72413793103448
ED 33,99.00%,426,216,17,4,2,AD   86,86033,665,233,430,-197,35.037593984962406,64.66165413533834,-29.624060150375932
ED 34,99.00%,297,175,9,7,5,AD   86,86034,493,184,304,-120,37.32251521298174,61.66328600405679,-24.34077079107505
ED 35,99.00%,184,54,2,7,0,AD   86,86035,247,56,191,-135,22.672064777327936,77.32793522267207,-54.655870445344135
ED 36,99.00%,279,93,8,5,5,AD   86,86036,390,101,284,-183,25.8974358974359,72.82051282051282,-46.92307692307692
ED 37,99.00%,378,129,7,15,5,AD   86,86037,534,136,393,-257,25.468164794007492,73.59550561797754,-48.127340823970044
ED 38,99.00%,389,136,11,16,3,AD   86,86038,555,147,405,-258,26.486486486486488,72.97297297297297,-46.486486486486484
ED 39,99.00%,209,86,10,9,1,AD   86,86039,315,96,218,-122,30.476190476190478,69.2063492063492,-38.73015873015872
ED 40,99.00%,39,23,0,3,0,AD   86,86040,65,23,42,-19,35.38461538461539,64.61538461538461,-29.230769230769226
ED 41,99.00%,368,147,10,12,5,AD   86,86041,542,157,380,-223,28.96678966789668,70.11070110701108,-41.143911439114405
ED 42,99.00%,39,15,0,1,0,AD   86,86042,55,15,40,-25,27.27272727272727,72.72727272727273,-45.45454545454547
ED 43,99.00%,375,144,7,11,5,AD   86,86043,542,151,386,-235,27.85977859778598,71.21771217712177,-43.35793357933579
ED 44,99.00%,90,37,0,2,2,AD   86,86044,131,37,92,-55,28.24427480916031,70.22900763358778,-41.984732824427475
ED 45,99.00%,62,42,1,3,0,AD   86,86045,108,43,65,-22,39.81481481481482,60.18518518518518,-20.370370370370367
ED 46,99.00%,208,117,5,7,2,AD   86,86046,339,122,215,-93,35.9882005899705,63.421828908554566,-27.433628318584063
ED 47,99.00%,316,137,6,6,1,AD   86,86047,466,143,322,-179,30.686695278969957,69.09871244635193,-38.41201716738197
ED 48,99.00%,258,115,7,11,4,AD   86,86048,395,122,269,-147,30.886075949367086,68.10126582278481,-37.21518987341773
ED 49,99.00%,433,134,11,12,3,AD   86,86049,593,145,445,-300,24.45193929173693,75.04215851602024,-50.5902192242833
ED 50,99.00%,384,189,8,23,5,AD   86,86050,609,197,407,-210,32.34811165845649,66.83087027914614,-34.48275862068965
ED 51,99.00%,336,187,7,6,5,AD   86,86051,541,194,342,-148,35.85951940850277,63.21626617375231,-27.35674676524954
ED 52,99.00%,393,232,9,8,6,AD   86,86052,648,241,401,-160,37.191358024691354,61.882716049382715,-24.69135802469136
ED 53,99.00%,269,122,8,12,3,AD   86,86053,414,130,281,-151,31.40096618357488,67.8743961352657,-36.47342995169082
ED 54,99.00%,0,0,0,0,0,AD   86,86054,0,0,0,0,,,0.0
ED 55,99.00%,0,0,0,0,0,AD   86,86055,0,0,0,0,,,0.0
ED 1,99.00%,121,30,2,6,0,AD   87,87001,159,32,127,-95,20.125786163522015,79.87421383647799,-59.74842767295598
ED 2,99.00%,363,152,9,12,3,AD   87,87002,539,161,375,-214,29.87012987012987,69.57328385899815,-39.70315398886828
ED 3,99.00%,407,194,10,15,5,AD   87,87003,631,204,422,-218,32.32963549920761,66.87797147385103,-34.54833597464342
ED 4,99.00%,221,83,8,6,3,AD   87,87004,321,91,227,-136,28.34890965732087,70.7165109034268,-42.36760124610592
ED 5,99.00%,168,57,3,2,0,AD   87,87005,230,60,170,-110,26.08695652173913,73.91304347826086,-47.826086956521735
ED 6,99.00%,487,166,12,23,6,AD   87,87006,694,178,510,-332,25.64841498559078,73.48703170028818,-47.83861671469741
ED 7,99.00%,449,142,6,13,7,AD   87,87007,617,148,462,-314,23.9870340356564,74.87844408427877,-50.89141004862237
ED 8,99.00%,141,50,4,5,2,AD   87,87008,202,54,146,-92,26.732673267326735,72.27722772277228,-45.54455445544555
ED 9,99.00%,468,154,12,18,4,AD   87,87009,656,166,486,-320,25.304878048780488,74.08536585365853,-48.78048780487804
ED 10,99.00%,303,119,12,12,4,AD   87,87010,450,131,315,-184,29.11111111111111,70.0,-40.888888888888886
ED 11,99.00%,386,171,16,17,11,AD   87,87011,601,187,403,-216,31.114808652246257,67.0549084858569,-35.940099833610645
ED 12,99.00%,359,112,7,33,8,AD   87,87012,519,119,392,-273,22.928709055876688,75.52986512524085,-52.60115606936416
ED 13,99.00%,334,117,10,8,12,AD   87,87013,481,127,342,-215,26.403326403326403,71.10187110187111,-44.69854469854471
ED 14,99.00%,492,144,6,24,29,AD   87,87014,695,150,516,-366,21.58273381294964,74.24460431654676,-52.661870503597115
ED 15,99.00%,559,100,14,18,12,AD   87,87015,703,114,577,-463,16.216216216216218,82.07681365576103,-65.86059743954482
ED 16,99.00%,517,125,9,17,10,AD   87,87016,678,134,534,-400,19.76401179941003,78.76106194690266,-58.99705014749263
ED 17,99.00%,457,85,7,21,16,AD   87,87017,586,92,478,-386,15.699658703071673,81.56996587030717,-65.8703071672355
ED 18,99.00%,610,97,11,25,15,AD   87,87018,758,108,635,-527,14.24802110817942,83.7730870712401,-69.52506596306068
ED 19,99.00%,599,115,15,23,12,AD   87,87019,764,130,622,-492,17.015706806282722,81.41361256544502,-64.3979057591623
ED 20,99.00%,479,93,8,25,14,AD   87,87020,619,101,504,-403,16.31663974151858,81.421647819063,-65.10500807754443
ED 21,99.00%,471,108,10,45,5,AD   87,87021,639,118,516,-398,18.466353677621285,80.75117370892019,-62.284820031298906
ED 22,99.00%,505,132,15,25,9,AD   87,87022,686,147,530,-383,21.428571428571427,77.25947521865889,-55.83090379008746
ED 23,99.00%,593,138,15,38,17,AD   87,87023,801,153,631,-478,19.101123595505616,78.7765293383271,-59.67540574282148
ED 24,99.00%,560,160,15,24,31,AD   87,87024,790,175,584,-409,22.151898734177212,73.9240506329114,-51.772151898734194
ED 25,85.71%,502,164,13,22,14,AD   87,87025,715,177,524,-347,24.755244755244753,73.2867132867133,-48.53146853146854
ED 26,85.71%,466,156,14,11,20,AD   87,87026,667,170,477,-307,25.487256371814095,71.51424287856072,-46.026986506746624
ED 27,85.71%,405,163,11,25,21,AD   87,87027,625,174,430,-256,27.839999999999996,68.8,-40.96
ED 28,99.00%,434,204,14,19,17,AD   87,87028,688,218,453,-235,31.686046511627907,65.84302325581395,-34.15697674418604
ED 29,99.00%,374,136,11,25,26,AD   87,87029,572,147,399,-252,25.699300699300696,69.75524475524476,-44.05594405594407
ED 30,99.00%,413,193,19,15,26,AD   87,87030,666,212,428,-216,31.83183183183183,64.26426426426426,-32.43243243243242
ED 31,99.00%,421,243,18,20,32,AD   87,87031,734,261,441,-180,35.55858310626703,60.08174386920982,-24.523160762942787
ED 32,99.00%,429,227,16,19,21,AD   87,87032,712,243,448,-205,34.12921348314607,62.92134831460674,-28.79213483146067
ED 33,99.00%,1,3,1,0,0,AD   87,87033,5,4,1,3,80.0,20.0,60.0
ED 34,99.00%,134,72,6,11,10,AD   87,87034,233,78,145,-67,33.47639484978541,62.231759656652365,-28.755364806866957
ED 35,99.00%,314,105,7,21,5,AD   87,87035,452,112,335,-223,24.778761061946902,74.11504424778761,-49.336283185840706
ED 36,99.00%,43,33,1,1,0,AD   87,87036,78,34,44,-10,43.58974358974359,56.41025641025641,-12.820512820512818
ED 37,99.00%,34,8,0,0,0,AD   87,87037,42,8,34,-26,19.047619047619047,80.95238095238095,-61.9047619047619
ED 38,99.00%,363,202,9,13,14,AD   87,87038,601,211,376,-165,35.108153078202996,62.562396006655575,-27.45424292845258
ED 39,99.00%,350,240,5,15,22,AD   87,87039,632,245,365,-120,38.765822784810126,57.75316455696202,-18.987341772151893
ED 40,99.00%,405,152,8,6,18,AD   87,87040,589,160,411,-251,27.164685908319186,69.77928692699491,-42.61460101867573
ED 41,99.00%,283,197,7,14,25,AD   87,87041,526,204,297,-93,38.78326996197718,56.463878326996195,-17.680608365019012
ED 42,99.00%,506,182,19,26,22,AD   87,87042,755,201,532,-331,26.62251655629139,70.4635761589404,-43.84105960264901
ED 43,99.00%,331,152,7,11,19,AD   87,87043,520,159,342,-183,30.57692307692308,65.76923076923077,-35.19230769230769
ED 44,99.00%,349,159,17,14,24,AD   87,87044,563,176,363,-187,31.261101243339258,64.47602131438721,-33.214920071047956
ED 45,99.00%,456,192,19,15,16,AD   87,87045,698,211,471,-260,30.229226361031518,67.47851002865329,-37.24928366762177
ED 46,99.00%,488,102,10,12,1,AD   87,87046,613,112,500,-388,18.270799347471453,81.56606851549756,-63.29526916802611
ED 47,99.00%,457,197,19,21,11,AD   87,87047,705,216,478,-262,30.638297872340424,67.80141843971631,-37.16312056737589
ED 48,99.00%,461,186,12,26,8,AD   87,87048,693,198,487,-289,28.57142857142857,70.27417027417027,-41.702741702741704
ED 49,99.00%,545,116,11,21,3,AD   87,87049,696,127,566,-439,18.24712643678161,81.32183908045977,-63.074712643678154
ED 50,99.00%,337,92,10,5,1,AD   87,87050,445,102,342,-240,22.92134831460674,76.85393258426966,-53.93258426966292
ED 51,99.00%,384,116,7,13,2,AD   87,87051,522,123,397,-274,23.563218390804597,76.0536398467433,-52.4904214559387
ED 52,99.00%,323,60,5,18,1,AD   87,87052,407,65,341,-276,15.970515970515969,83.78378378378379,-67.81326781326783
ED 53,99.00%,480,129,13,9,8,AD   87,87053,639,142,489,-347,22.22222222222222,76.52582159624414,-54.30359937402192
ED 54,99.00%,574,117,5,19,1,AD   87,87054,716,122,593,-471,17.039106145251395,82.82122905027933,-65.78212290502793
ED 55,99.00%,448,166,13,18,8,AD   87,87055,653,179,466,-287,27.411944869831544,71.36294027565084,-43.9509954058193
ED 56,99.00%,4,3,0,1,0,AD   87,87056,8,3,5,-2,37.5,62.5,-25.0
ED 57,99.00%,0,0,0,0,0,AD   87,87057,0,0,0,0,,,0.0
ED 58,99.00%,0,0,0,0,0,AD   87,87058,0,0,0,0,,,0.0
ED 59,99.00%,0,0,0,0,0,AD   87,87059,0,0,0,0,,,0.0
